43 43
WWWWWWWWWWWWWWWOOOOOOOOOOOOOOOOOOOOOOOOOOOO
WXXXMXXXXXXXXXWOOOOOOOOOOOOOOOOOOOOOOOOOOOO
WXMXXXXXXXXMXXWOOOOOOOOOOOOOOOOOOOOOOOOOOOO
WXXXMXXXXXXXXXWOOOOOOOOOOOOOOOOOOOOOOOOOOOO
WXMXXXXXXXXXXXWOOOOOOOOOOOOOOOOOOOOOOOOOOOO
WLXXXXXXMXXXXXWOOOOOOOOOOOOOOOOOOOOOOOOOOOO
WXXXXXXXXXXXXXWOOOOOOOOOOOOOOOOOOOOOOOOOOOO
WXXXXXXXXXXXXXWOOOOOOOOOOOOOOOOOOOOOOOOOOOO
WXXXXXXXXXXXXXWOOOOOOOOOOOOOOOOOOOOOOOOOOOO
WXXMXXXXXXXXXXWOOOOOOOOOOOOOOOOOOOOOOOOOOOO
WXXXXMMXXXXXXXWOOOOOOOOOOOOOOOOOOOOOOOOOOOO
WXXMMXXXXXXXXXWOOOOOOOOOOOOOOOOOOOOOOOOOOOO
WXXXXXXXXXXXXXWOOOOOOOOOOOOOOOOOOOOOOOOOOOO
WXXXXXBXXXXXXXWOOOOOOOOOOOOOWWWWWOOOOOOOOOO
WWWWWWWWWWXXXWWOOOOOOOOOOOOOWXXXWOOOOOOOOOO
OOOOOOOOWWXXXWWWWWWWWWWOOOOOWXSXWOOOOOOOOOO
OOOWWWWWWXXMXXXXXMXXXXWOOOOOWXXXWOOOOOOOOOO
OOOWXXXXXXNXXMXXXXXXXXWOOOOOWXXXWOOOOOOOOOO
OOOWXSXXXXXXXXXXXXXXXXWWWWWWWXXXWOOOOOOOOOO
OOOWXXXXXXXXXXXXXXXXXXWWXXXXXXXXWOOOOOOOOOO
OOOWWWWWWXXXMXXXXXLXXXWWXXXXXXXXWOOOOOOOOOO
OOOOOOOOWXXXXXXXXXXXXXWWXXXXXXXXWOOOOOOOOOO
OOOOOOOOWXXXXBMXMXXXXXWWWWWWWXXXWOOOOOOOOOO
OOOOOOOOWMXXXXXXXXXMXXWWWWWWWXXXWWWWWWOOOOO
OOOOOOOOWXBXXBMXXMXXXXWWXXXXXXXXXXXXXWOOOOO
OOOOOOOOWXMXXXXXXMXXXXXXXXXXXXXXXXXXXWOOOOO
OOOOOOOOWXXXXXXXXXXMXXXXXXXXXXXXXXNXXWOOOOO
OOOOOOOOWXXXXXXXXXXXXXXXXXXNXXXXXXXXXWOOOOO
OOOOOOOOWXXXXXXXXXXXXXWWXXXXXXDDXXXXXWOOOOO
OOOOOOOOWWWWWWXXXWWWWWWWXXXXXXXXXXXXXWOOOOO
OOOOOOOOOOOOOWXXXWOOOOOWXXXXXXHXXXXXXWOOOOO
OOOOOOOOOOOOOWXXXWOOOOOWXXXXXXXXXXXXXWOOOOO
OOOOOOOOOOOOOWXLXWWWWWWWXXXXXXXXXXXXXWWWWWW
OOOOOOOOOOOOOWXXXWWXXXXXXXXXXXXXXXXXXXXXXXW
OOOOOOOOOOOOOWWWWWWXLLXXXXXNXMXMXXXXXXXXNXW
OOOOOOOOOOOOOOOOOOWXXXXXXXXXXXXXXXXXXXXXXXW
OOOOOOOOOOOOOOOOOOWWWWWWXXXXXXXXXXXXXWWWWWW
OOOOOOOOOOOOOOOOOOOOOOOWWWWWWXXXWWWWWWOOOOO
OOOOOOOOOOOOOOOOOOOOOOOOOOOOWXXXWOOOOOOOOOO
OOOOOOOOOOOOOOOOOOOOOOOOOOOOWXXXWOOOOOOOOOO
OOOOOOOOOOOOOOOOOOOOOOOOOOOOWXNXWOOOOOOOOOO
OOOOOOOOOOOOOOOOOOOOOOOOOOOOWXXXWOOOOOOOOOO
OOOOOOOOOOOOOOOOOOOOOOOOOOOOWWWWWOOOOOOOOOO
