40 60
OOOOOOOOOOOOOOOOOOOOOOOOOOOOOOOOOOOOOOOO
OOOOOOOWWWWWWWWWWWWWWWWWWWWWWWWWOOOOOOOO
OOOOOOOWXXXXXXXXXXXXXXXXXXXXXXXWOOOOOOOO
OOOOOOOWXXXXXXXXXXXDDXXXXXXXXXXWOOOOOOOO
OOOOOOOWXXWWWXXXXXXXXXXXXXWWWXXWOOOOOOOO
OOOOOOOWXXXXWXXXXXXXXXXXXXWXXXXWOOOOOOOO
OOOOOOOWXXLXWXXXXXXXXXXXXXWXLXXWOOOOOOOO
OOOOOOOWXXXXWXXXXLXPXLXXXXWXXXXWOOOOOOOO
OOOOOOOWXXWWWXXXXNXXXNXXXXWWWXXWOOOOOOOO
OOOOOOOWXXXXXXXXXXXXXXXXXXXXXXXWOOOOOOOO
OOOOOOOWXXXXXXXXXXXXXXXXXXXXXXXWOOOOOOOO
OOOOOOOWXXXXXXXXXXXXXXXXXXXXXXXWOOOOOOOO
OOOOOOOWXXWWWXXXXXXXXXXXXXWWWXXWOOOOOOOO
OOOOOOOWXXXXWXXXXXXXXXXXXXWXXXXWOOOOOOOO
OOOOOOOWXXNXWXXXXXXXXXXXXXWXNXXWOOOOOOOO
OOOOOOOWXXXXWXXXXXXXXXXXXXWXXXXWOOOOOOOO
OOOOOOOWXXWWWXXXXXXXXXXXXXWWWXXWOOOOOOOO
OOOOOOOWXXXXXXXXXXXXXXXXXXXXXXXWOOOOOOOO
OOOOOOOWXXXXXXXXXXXXXXXXXXXXXXXWOOOOOOOO
OOOOOOOWXXWWWXXXXXXXXXXXXXWWWXXWOOOOOOOO
OOOOOOOWXXXXWXXXXXXXXXXXXXWXXXXWOOOOOOOO
OOOOOOOWXXLXWXXXXXXXXXXXXXWXLXXWOOOOOOOO
OOOOOOOWXXXXWXXXXXXXXXXXXXWXXXXWOOOOOOOO
OOOOOOOWXXWWWXXXXXXXXXXXXXWWWXXWOOOOOOOO
OOOOOOOWXXXXXXXXXXXXXXXXXXXXXXXWOOOOOOOO
OOOOOOOWXXXXXXXXXXXXXXXXXXXXXXXWOOOOOOOO
OOOOOOOWWWWWWWWWWWXXXXXWWWWWWWWWOOOOOOOO
OOOOOOOOOOOOOOOOOWXXXXXWOOOOOOOOOOOOOOOO
OOOOOOOOOOOOOOOOOWXXXXXWOOOOOOOOOOOOOOOO
OOOOOOOOOOOOOOOOOWXXXXXWOOOOOOOOOOOOOOOO
OOOOOOOOOOOOOOOOOWXXXXXWOOOOOOOOOOOOOOOO
OOOOOOOOOOOOOOOOOWXXXXXWOOOOOOOOOOOOOOOO
OOOOOOOOOOOOOOOOOWXXXXXWOOOOOOOOOOOOOOOO
OOOOOOOOOOOOOOOOOWXXXXXWOOOOOOOOOOOOOOOO
OOOOOOOOOOOOOOOOOWXXXXXWOOOOOOOOOOOOOOOO
OOOOOOOOOOOOOOOOOWXXXXXWOOOOOOOOOOOOOOOO
OOOOOOOOOOOOOOOOOWXXXXXWOOOOOOOOOOOOOOOO
OOOOOOOOOOOOOOOOOWXXXXXWOOOOOOOOOOOOOOOO
OOOOOOOOOOOOOOOOOWXXXXXWOOOOOOOOOOOOOOOO
OOOOOOOOOOOOOOOOOWXXXXXWOOOOOOOOOOOOOOOO
OOOOOOOOOOOOOOOOOWXXXXXWOOOOOOOOOOOOOOOO
OOOOOOOOOOOOOOOOOWXXXXXWOOOOOOOOOOOOOOOO
OOOOOOOOOOOOOOOOOWXXXXXWOOOOOOOOOOOOOOOO
OOOOOOOOOOOOOOOOOWXXXXXWOOOOOOOOOOOOOOOO
OOOOOOOOOOOOOOOOOWXXXXXWOOOOOOOOOOOOOOOO
OOOOOOOOOOOOOOOOOWXXXXXWOOOOOOOOOOOOOOOO
OOOOOOOOOOOOOOOOOWXXXXXWOOOOOOOOOOOOOOOO
OOOOOOOOOOOOOOOOOWXXXXXWOOOOOOOOOOOOOOOO
OOOOOOOOOOOOOOOOOWXXXXXWOOOOOOOOOOOOOOOO
OOOOOOOOOOOOOOOOOWXXXXXWOOOOOOOOOOOOOOOO
OOOOOOOOOOOOOOOWWWXXXXXWWWOOOOOOOOOOOOOO
OOOOOOOOOOOOOOOWLXXXXXXXNWOOOOOOOOOOOOOO
OOOOOOOOOOOOOOOWLXXXXXXXNWOOOOOOOOOOOOOO
OOOOOOOOOOOOOOOWLXXXHXXXNWOOOOOOOOOOOOOO
OOOOOOOOOOOOOOOWWWXXXXXWWWOOOOOOOOOOOOOO
OOOOOOOOOOOOOOOOOWXXSXXWOOOOOOOOOOOOOOOO
OOOOOOOOOOOOOOOOOWWWWWWWOOOOOOOOOOOOOOOO
OOOOOOOOOOOOOOOOOOOOOOOOOOOOOOOOOOOOOOOO
OOOOOOOOOOOOOOOOOOOOOOOOOOOOOOOOOOOOOOOO
OOOOOOOOOOOOOOOOOOOOOOOOOOOOOOOOOOOOOOOO
