21 21
WWWWWWWWWWEWWWWWWWWWW
WSXXXXXXXXHXXXXXXXXSW
WXXXXXXXXXXXXXXXXXXXW
WXXWWWWWWXXXWWWWWWXXW
WXXWLMXXXXXXXXXRLWXXW
WXXWXXXXXXXXXXXXXWXXW
WXXWXXXXXXWXXXXXXWXXW
WXRWXXXXXXWXXXXXXWXMW
WXXXXXXXXXWXXXXXXWXXW
WXXXXXMXNWWWNXMXXXXXW
WXXXXXWWWWWWWWWXXXXXW
WXXXXXXRNWWWNRXXXXXXW
WXXWXXXXXXWXXXXXXWXXW
WXXWXXMXXXWXXXrXXWXXW
WXXWXXXXXXWXXXXXXWXRW
WXXWXXXXXXXXXXXXXWXXW
WXXWLXXXXXXXXXXXLWXXW
WXXWWWWWWmMmWWWWWWRXW
WXXXMDDRXXXXXXXXXXXXW
WXXXXXXXXXXXXXXXXXXLW
WWWWWWWWWWWWWWWWWWWWW
