21 21
WWWWWWWWWWWWWWWWWWWWW
WXXXXXXXXXXXXXXXXXXXW
WXXXXXXXXXXXXXXXXXXXW
WXXWWWWWWXXXWWWWWWXXW
WXXWSSSXXXXXXXXXXWXXW
WXXWSSSNLXXXXXXXXWXXW
WXXWXXXXXXWXXXXXXWXXW
WXXWXXXHXXWXXDDXXWXXW
WXXXXXXXXXWXXXXXXWXXW
WXXXXXXXXWWWXXXXXXXXW
WXXXXXWWWWWWWWWXXXXXW
WXXXXXXXRWWWXXXXXXXXW
WXXWXXXXmXWXXXXXXWXXW
WXXWXXXXMXWXXXXXXWXXW
WXXWXXXXXXWXXXXXXWXXW
WXXWXXXXXXXXXXXXXWXXW
WXXWXXXXXXXXXXXXXWXXW
WXXWWWWWWXXXWWWWWWXXW
WXXXXXXXXXXXXXXXXXXXW
WXXXXXXXXXXXXXXXXXXXW
WWWWWWWWWWWWWWWWWWWWW
