8 7
WWWWWWWW
WHXXXXXW
WXXXXXXW
WXXDDXXW
WXXXXXXW
WXXXXXXW
WWWWWWWW
