10 10
WWWWWWWWWW
WXXXXXXXXW
WXMXXXXMXW
WXXXXXXXXW
WXXXHXXXXW
WXXXXXXXXW
WXXXXXXXXW
WXXXXXXXXW
WXXXXXXXXW
WXXXXXXXXW
