10 9
WWWWEWWWWW
WXXXHXXXXW
WXXXXXXXXW
WXXXXXXXXW
WXXXXXXXXW
WXXXXDDXXW
WXXXXXXXXW
WXXXXXXXXW
WWWWWWWWWW
