94 80
O O O O O O O O O O O O O O O O O O O O O O O O O O O O O O O O O O O O O O O O O O O O O O O O O O O W W W W W W W W W W W W W W W O W W W W W W W W W W W W W W W O O O O O O O O O O O O 
O O O O O O O O O O O O O O O O O O O O O O O O O O O O O O O O O O O O O O O O O O O O O O O O O O O W X X X M X X X X X X X X X W O W X X M X X X X X X X X X X W O O O O O O O O O O O O 
O O O O O O O O O O O O O O O O O O O O O O O O O O O O O O O O O O O O O O O O O O O O O O O O O O O W X X X X X X X X X X X X X W O W X X X X X X X X X X X X X W O O O O O O O O O O O O 
O O O O O O O O O O O O O O O O O O O O O O O O O O O O O O O O O O O O O O O O O O O O O O O O O O O W X X X X X X X X X X X X X W O W X X X X X X X X X X X X X W O O O O O O O O O O O O 
O O O O O O O O O O O O O O O O O O O O O O O O O O O O O O O O O O O O O O O O O O O O O O O O O O O W X X X X X X X X X M X X X W O W X X X X X X X X X X X X X W O O O O O O O O O O O O 
O O O O O O O O O O O O O O O O O O O O O O O O O O O O O O O O O O O O O O O O O O O O O O O O O O O W X X X X X X M X X X M X X W O W X X X X X X X X X X X X X W O O O O O O O O O O O O 
O O O O O O O O O O O O O O O O O O O O O O O O O O O O O O O O O O O O O O O O O O O O O O O O O O O W X X X X X X X M X X X X X W O W X X X X X X X X X X X X X W O O O O O O O O O O O O 
O O O O O O O O O O O O O O O O O O O O O O O O O O O O O O O O O O O O O O O O O O O O O O O O O O O W X X X X X X X X X X X X X W O W X X X X X X X X X X X X X W O O O O O O O O O O O O 
O O O O O O O O O O O O O O O O O O O O O O O O O O O O O O O O O O O O O O O O O O O O O O O O O O O W X X X X X X X X X X X X X W O W X X X X X M X X X X X X X W O O O O O O O O O O O O 
O O O O O O O O O O O O O O O O O O O O O O O O O O O O O O O O O O O O O O O O O O O O O O O O O O O W X X X X X X X X X X X X X W O W X X X X X X X X X X X X X W O O O O O O O O O O O O 
O O O O O O O O O O O O O O O O O O O O O O O O O O O O O O O O O O O O O O O O O O O O O O O O O O O W X X X X X X X X X X X X X W O W X X X X X X X X X X X X X W O O O O O O O O O O O O 
O O O O O O O O O O O O O O O O O O O O O O O O O O O O O O O O O O O O O O O O O O O O O O O O O O O W X X X X M X X X X X X X X W O W X X X X X X X X X X X X X W O O O O O O O O O O O O 
O O O O O O O O O O O O O O O O O O O O O O O O O O O O O O O O O O O O O O O O O O O O O O O O O O O W X X X X X X X X X X X X X W O W X X X X X X X X X X X X X W O O O O O O O O O O O O 
O O O O O O O O O O O O O O O O O O O O O O O O O O O O O O O O O O O O O O O O O O O O O O O O O O O W X X X X X X X X X X X X X W O W X X X X X X X X X X X X X W O O O O O O O O O O O O 
O O O O O O O O O O O O O O O O O O O O O O O O O O O O O O O O O O O O O O O O O O O O O O O O O O O W W W W W W W W W W X X X W W O W W X X X W W W W W W W W W W O O O O O O O O O O O O 
O O O O O O O O O O O O O O O O O O O O O O O O O O O O O O O O O O O O O O O O O O O O O O O O O O O O O O O O O O O W W X X X W W W W W X X X W W W W W W W W W W W W W W W W W O O O O O 
O O O O O O O O O O O O O O O O O O O O O O O O O O O O O O O O O O O O O O O O O O O O O O O O O O O O O O O O O O O W X M X M M X X X X X X X X W W X X X X X X X X X X X X X W O O O O O 
O O O O O O O O O O O O O O O O O O O O O O O O O O O O O O O O O O O O O O O O O O O O O O O O O O O O O O O O O O O W X X X X X X X X X X X X X X X X X X X X X X X X X X X X W O O O O O 
O O O O O O O O O O O O O O O O O O O O O O O O O O O O O O O O O O O O O O O O O O O O O O O O O O O O O O O O O O O W X X M X X X X X X X X X X X X X X X X X X X X X X X X X W O O O O O 
O O O O O O O O O O O O O O O O O O O O O O O O O O O O O O O O O O O O O O O O O O O O O O O O O O O O O O O O O O O W X X X X X X X X X X X X X X X X X X X X X X X X X X X X W O O O O O 
O O O O O O O O O O O O O O O O O O O O O O O O O O O O O W W W W W O O O O O O O O O O O O O O O O O O O O W W W W W W X X X X X X X X X X X X X W W X X X X X X X X X X X X X W O O O O O 
O O O O O O O O O W W W W W W W W W W W W W W W O O O O O W X X X W O O O O O O O O O O O O O O O O O O O O W X X X X X X X X X X X X X X X X X X W W X X X X X X X M X X X X X W O O O O O 
O O O O O O O O O W X X X X X X X X X X X X X W O O O O O W X X X W O O O O O O O O O O O O O O O O O O O O W X X X X X X X X X X X X X X X X X X W W X X X X X X X X X X X X X W O O O O O 
O O O O O O O O O W X X X X X X X X X X X X X W O O O O O W X X X W O O O O O O O O O O O O O O O O O O O O W X X X X X X M X X X X X X X X X X X W W X X X X X X X X X X X X X W O O O O O 
O O O O O O O O O W X X X X X X X X X X X X X W O O O O O W X X X W O O O O O O O O O O O O O O O O O O O O W W W W W W X X X X X X X X X X X X X W W X X X X X X X X X X X X X W O O O O O 
O O O O O O O O O W X X X X X X X X X X X X X W W W W W W W X X X W W W W W W O O O O O O O O O O O O O O O O O O O O W X X X X X X X X X X X X X W W X X X X X X X X X X X X X W O O O O O 
O O O O W W W W W W X X X X X X X X X X X X X W W X X X X X X X X X X X X X W O O O O O O O O O O O O O O O O O O O O W X X X X X X X X X X X X X W W X X X X X X X X X X X X X W O O O O O 
O O O O W X X X X X X X X X X X X X X M X X X W W X X X X X X X X X X X X X W O O O O O O O O O O O O O O O O O O O O W X X X X X X X X X X X X X W W X X X X X X X X X X X X X W O O O O O 
O O O O W X X X X X X X X X M X X X X X X X X W W X X X X X X X X X X M X X W O O O O O O O O O O O O O O O O O O O O W X X X X X X X X X X X X X W W X X X X X X X X X X X X X W O O O O O 
O O O O W X X X X X X X X X X X X X X X X X X W W X X X X X X X X X X X X X W W W W W W W W W W W O O O O O O O O O O W W W W W W X X X W W W W W W W W W W W W W W W W W W W W W O O O O O 
O O O O W W W W W W X X X X X X X X X X X X X W W X X X X X X X X X X X X X W W X X X X X X X X W O O O O O O O O O O W W W W W W X X X W W W W W W W W W W W W W W W W W W W W W O O O O O 
O O O O O O O O O W X X X X X X M X X X X X X W W X X X X X X X X X X X X X W W X X X X X X X X W O O O O O O O O O O W X X X X X X X X X X X X X W W X X X X X X X X X X X X X W O O O O O 
W W W W W O O O O W M M X X X X X X X X X X X W W X X X X X X X X X X X X X W W X X X X X X X X W O O O O O O O O O O W X X X X X X X X M X X X X X X X X X X X X X X X X X X X W O O O O O 
W X X X W O O O O W X X X X X X X X X X X X X W W X M X X X X X X X X X X X W W W W W W W X X X W O O O O O O O O O O W X X M X X X X X X X X X X X X X X X X X X X X X X X X X W O O O O O 
W X X X W O O O O W X X X X X X X X X X X X X W W X X X X X X X X X X X X X W W W W W W W X X X W W W W W W O O O O O W X X X X M X X X X X X X X X X X X X X X X X M X X X X X W O O O O O 
W X X X W O O O O W W X X X W W W W W W W W W W W X X X X X X X X X X X X X W W X X X X X X X X X X X X X W O O O O O W X X X X X X X X X X X X X W W X X X X X X X X X X X X X W W W W W W 
W X X X W W W W W W W X X X W W W W W W O O O O W X X X X X X X X X X X X X W W X X X X X X X X X X X X X W O O O O O W X X X X X X X X X X X X X W W X X X X X X X X X X X X X X X X X X W 
W X X X W W X X X X X X X X X X X X X W O O O O W X X X X X X X X X X X X X W W X X X X X X X X X X X X X W O O O O O W X X X X X X X X X X M X X W W X X X X X X X X X X X X X X X X X X W 
W X X X X X X X X X X X X X X X X X X W O O O O W X X X X X X X X X X X X X W W X X X X X X X X X X M X X W O O O O O W X X X X X X X X X X X X X W W X X X X X X X M X X X X X X X X X X W 
W X X X X X X X X X X X X X X M M X X W O O O O W W X X X W W W W W W W W W W W X X X M X X X X X X M X X W W W W W W W X X X X X X M X X X X X X W W X X X X X X X X X X X X X W W W W W W 
W X X X X X X X X X M X X X M X X X X W O O O O O W X X X W O O O O O O O O O W X X X X X X X X X X X X X X X X X X X X X X X X X X X X X M X X X W W X X X X X X X X M X X X X W O O O O O 
W W W W W W X X X X X X X X X X X X X W O O O O O W X X X W O O O O O O O O O W X X X X X X X X X X X X X X X X X X X X X M X X X X X X X X X X X W W X X X X M X X X X X X X X W O O O O O 
O O O O O W X X X X X X M X X X X X X W O O O O O W X X X W O O O O O O O O O W X X X X X X X X X X X X X X X X X X X X X X X X X X X X X X X X X W W X X X X X X X X X X X X X W O O O O O 
O O O O O W X X X X X X X X X X X X X W O O O O O W X X X W O O O O O O O O O W X X X X X X X X X X X X X W W W W W W W X X X X X X X X X X X X X W W X X X X X X X X X X X X X W O O O O O 
O O O O O W X X X X X X X X X X X X X W O O O O O W X X X W O O O O O O O O O W X X X X X X X X X X X X X W O O O O O W W W W W W X X X W W W W W W W W W W W W W W W W W W W W W O O O O O 
W W W W W W X X X X X X X X X X X X X W W W W W W W X X X W O O O O O O O O O W X X X M X X X X X X X X X W O O O O O O O O O O W X X X W O O O O O O O O O O O O O O O O O O O O O O O O O 
W X X X X X X M X X X X X X X X X X X X X X X X X X X X X W O O O O O O O O O W X X X X X X X X X X X X X W O O O O O O O O O O W X X X W O O O O O O O O O O O O O O O O O O O O O O O O O 
W X X X X X X X X X X X X X X X X X X X X X X X X X X X X W O O O O O O O O O W X X X X X X X X X X X X X W O O O O O O O O O O W X X X W O O O O O O O O O O O O O O O O O O O O O O O O O 
W X X X X X X X X X X X X X X X X X X X X X X X X X X X X W O O O O O O O O O W W W W W W X X X W W W W W W O O O O O O O O O O W X X X W O O O O O O O O O O O O O O O O O O O O O O O O O 
W W W W W W X X X X X X X X X X X X X W W W W W W W X X X W O O O O O W W W W W W W W W W X X X W W O O O O O O O O O O O O O O W W W W W O O O O O O O O O O O O O O O O O O O O O O O O O 
O O O O O W W W W W W X X X W W W W W W O O O O O W X X X W W W W W W W X X X X X X X X X X X X X W W W W W W O O O O O O O O O O O O O O O O O O O O O O O O O O O O O O O O O O O O O O O 
O O O O O W W W W W W X X X W O O O O O O O O O O W X X X X X X X X X X X X X X X X X X X X X X X X X X X X W O O O O O O O O O O O O O O O O O O O O O O O O O O O O O O O O O O O O O O O 
O O O O O W X X X X X X X X W O O O O O O O O O O W X X X X X X H X X X X X D X X X X X X X X X X X X X X X W O O O O O O O O O O O O O O O O O O O O O O O O O O O O O O O O O O O O O O O 
O O O O O W X X X X X X X X W O O O O O O O O O O W X X X X X X X X X X X X X X X X X X X M X X X X X X X X W O O O O O O O O O O O O O O O O O O O O O O O O O O O O O O O O O O O O O O O 
O O O O O W X X X X X X X X W O O O O O O O O O O W X X X W W W W W W W X X X X X X X X X X X X X W W W W W W O O O O O O O O O O O O O O O O O O O O O O O O O O O O O O O O O O O O O O O 
O O O O O W W W W W W X X X W O O O O O O O O O O W X X X W O O O O O W X X X M X X X X X X X X X W O O O O O O O O O O O O O O O O O O O O O O O O O O O O O O O O O O O O O O O O O O O O 
O O O O O O O O O O W X X X W O O O O O O O O O O W X X X W O O O O O W X X X X X X X X X X X X X W O O O O O O O O O O O O O O O O O O O O O O O O O O O O O O O O O O O O O O O O O O O O 
O O O O O O O O O O W X X X W O O O O O O O O O O W X X X W O O O O O W X X X X X X M X X X X X X W O O O O O O O O O O O O O O O O O O O O O O O O O O O O O O O O O O O O O O O O O O O O 
O O O O O O O O O O W X X X W O O O O O O O O O O W X X X W O O O O O W X X X X X X X X M X X X X W W W W W W O O O O O O O O O O O O O O O O O O O O O O O O O O O O O O O O O O O O O O O 
O O O O O O O O O O W X X X W O O O O O O O O O O W W W W W O O O O O W X X X X X X X X X X M X X X X X X X W O O O O O O O O O O O O O O O O O O O O O O O O O O O O O O O O O O O O O O O 
O O O O O O O O O O W W W W W O O O O O O O O O O O O O O O O O O O O W X X X X X X X X X M X X X X X X X X W O O O O O O O O O O O O O O O O O O O O O O O O O O O O O O O O O O O O O O O 
O O O O O O O O O O O O O O O O O O O O O O O O O O O O O O O O O O O W X X X X X X X X X X X X X X X X X X W O O O O O O O O O O O O O O O O O O O O O O O O O O O O O O O O O O O O O O O 
O O O O O O O O O O O O O O O O O O O O O O O O O O O O O O O O O O O W X X X X X X X X X X X X X W W X X X W O O O O O O O O O O O O O O O O O O O O O O O O O O O O O O O O O O O O O O O 
O O O O O O O O O O O O O O O O O O O O O O O O O O O O O O O O O O O W W W W W W X X X W W W W W W W X X X W W W W W W O O O O O O O O O O O O O O O O O O O O O O O O O O O O O O O O O O 
O O O O O O O O O O O O O O O O O O O O O O O O O O O O O O O O O O O O O O O O W X X X W W W W W W W X X X X X X X X W O O O O O O O O O O O O O O O O O O O O O O O O O O O O O O O O O O 
O O O O O O O O O O O O O O O O O O O O O O O O O W W W W W W W W W W W W W W W W X X X X X X X X W W X X X X X X X X W O O O O O O O O O O O O O O O O O O O O O O O O O O O O O O O O O O 
O O O O O O O O O O O O O O O O O O O O O O O O O W X X X X X X X X X X X X X W W X X X X X X X X W W X X X X X X X X W O O O O O O O O O O O O O O O O O O O O O O O O O O O O O O O O O O 
O O O O O O O O O O O O O O O O O O O O O O O O O W X X X X X X X X X X X X X W W X X X X X X X X W W W W W W W X X X W O O O O O O O O O O O O O O O O O O O O O O O O O O O O O O O O O O 
O O O O O O O O O O O O O O O O O O O O O O O O O W X X X X X X X X X X X X X W W X X X W W X X X W O O O O O W X X X W O O O O O O O O O O O O O O O O O O O O O O O O O O O O O O O O O O 
O O O O O O O O O O O O O O O O O O O O O O O O O W X X X X X X X X X X X X X W W X X X W W X X X W O O O O O W X X X W O O O O O O O O O O O O O O O O O O O O O O O O O O O O O O O O O O 
O O O O O O O O O O O O O O O O O O O O O O O O O W X X X X X X X X X X X X X W W X X X W W X X X W O O O O O W X X X W O O O O O O O O O O O O O O O O O O O O O O O O O O O O O O O O O O 
O O O O O O O O O O O O O O O O O O O O O O O O O W X X X X X X X X X X X X X W W X X X W W X X X W O O O O O W X X X W O O O O O O O O O O O O O O O O O O O O O O O O O O O O O O O O O O 
O O O O O O O O O O O O O O O O O O O O O O O O O W X X X X X X X M X X X X X W W X X X W W X X X W O O O O O W W W W W O O O O O O O O O O O O O O O O O O O O O O O O O O O O O O O O O O 
O O O O O O O O O O O O O O O O O O O O O O O O O W X X X X X X X X X X X X X W W X X X W W X X X W O O O O O O O O O O O O O O O O O O O O O O O O O O O O O O O O O O O O O O O O O O O O 
O O O O O O O O O O O O O O O O O O O O O O O O O W X X X X X X X X X X X X X W W X X X W W X X X W O O O O O O O O O O O O O O O O O O O O O O O O O O O O O O O O O O O O O O O O O O O O 
O O O O O O O O O O O O O O O O O O O O O O O O O W X X X X X X X X X X X X X X X X X X W W X X X W O O O O O O O O O O O O O O O O O O O O O O O O O O O O O O O O O O O O O O O O O O O O 
O O O O O O O O O O O O O O O O O O O O O O O O O W X X X X X X M X X X X X X X X X X X W W X X X W O O O O O O O O O O O O O O O O O O O O O O O O O O O O O O O O O O O O O O O O O O O O 
O O O O O O O O O O O O O O O O O O O O O O O O O W X X X X X X X X X X X X X X X X X X W W X X X W O O O O O O O O O O O O O O O O O O O O O O O O O O O O O O O O O O O O O O O O O O O O 
O O O O O O O O O O O O O O O O O O O O O O O O O W X X X X X X X X X X X X X W W W W W W W W W W W O O O O O O O O O O O O O O O O O O O O O O O O O O O O O O O O O O O O O O O O O O O O 
O O O O O O O O O O O O O O O O O O O O O O O O O W W W W W W W W W W W W W W W O O O O O O O O O O O O O O O O O O O O O O O O O O O O O O O O O O O O O O O O O O O O O O O O O O O O O O 
