100 100
WWWWWWWWWWWWWWWWWWWWWWWWWWWWWWWWWWWWWWWWWWWWWWWWWWWWWWWWWWWWWWWWWWWWWWWWWWWWWWWWWWWWWWWWWWWWWWWWWWWW
WWXWXXXWXXXWXXXWWWWWWXXWWWWXXXXWXXWWXXXXWXXXXXWXWXWXXXXXWWWXWWWXWWXWWXXXXXWXXXXXWXWXXXWWWXXXXXWWXXWW
WXXWXWXXWXWXXWXXXWWXXWXXXWXXXXXWWXWXXXWXXXWXWXWXWXWXXWXXXXXWXXWXWXXXWXWWXWXWWWXXXXXWWWWXXWWXWWXXXXWW
WXWXWXWXXXWXXXXWWWXXXWXWXXWXWWXXWXXXXXXXXXXXWWXXXWWXXXWXWXXXXXWXXXXXWXXWXWWWXXXWWWWXXXXXWXXWWXWXXXXW
WWXWWXXXXWXXWWXWWXXXWXWXXXWXXXWWXWXXXXXWXXWXXWWWXXXWWWXWXXXXXWWXXWWWXWWWXXXXXXXWXXWWXWXXWXWWWXWWXXXW
WXXWXWXWWXXWWXXWWXWWWXWWWWXXXXXXXXXWWXXXWXWXXXXWXXXXWWWWXWXXWXXXXXXWXXXWXXXWXXWWWXXWXWXWWWXXWXXWXWXW
WXXWXWXWXWXWWWWWXXXWXXXXXXXWXXXXXXXWXWWXWWWXWWWXXXXXXXXXWXXWXWXXXXXWWWXXXXXWXXWWXWXXXXWWWXXWXWXWXXXW
WXWWWWWWXWWWXXWXXXXWXWXXXXXXXWWWXWWWXWWXWXXXXXWXXXXWXXWWWWXWWWXXXXXXXXXXWXXXXXXXWWWWWXWXWXXXWXXXXWXW
WXXXXXWXWWXXWXXWXXWWXXXWXXWXXWWWXXXWXWXWWXWWXWWWWXWXXWXXWXXXXWXWXXXWXXXXXWXXXXXXXXXXWWXXWWXXWWWXXWWW
WWWWXXWXXXWWWXXWXWXXXXWWXWXXWXXWXXXXXXXXWXWXXWXXXXXXXXXXWXXXXXXXXXWWWXXXWXWXXXWXWXWWXWWXXXWXWXXXXWWW
WWWXXXXXXXXXXWWXXXWXXWXXWWWWXWXXXXXXWXWXXWWWWXWXWWWWWWXXXWXXXXXXWXWXXXWXXXXWXXWXWXXXWXXXXXWWXWXWXXWW
WWWXWWXXXXXWXXWWWWXWWXWXWXWWWWXXXXXWWWWXWXXXXXXXXXXWWWWXXXWXXXXWXWXXXWXXWWXWXXWXXWWXWXXXWXXXXWXWWWXW
WXWWXWXWXXXWXXXXWXWWWXXXXXXXXWXWWXWXXXWXWXXXXWXXXWXXXWWXXXWWWXXXXWXWXXXXWXXXWWWXXXXXWXWXWXWXXXWWXXWW
WWXXWWXXXWXWXWWWWXXWWWWXXXXXWXXXXXXXXXWXWXXWXXWWWXXWWWXXXXWXXXWXWWWWXXWWWXWWXWXWXWWWXWXWXXXXXWWXXXWW
WXXWXXXWXXXXWWWXXWWXXXXXWXWXXWXXWWWWWXXXXXWXWXXWWXWXXXXXXXXXXWXXWXWXWWWXXXWWXXWWWWXWWWWXXWWWWXWXWXXW
WWWWXXXXWXXXXXXWXWWWWXXWXWXWWXWWXXWXWXXWWWXWWWWXXXXWXXXWXXXXXXWXWXXWXWXWXWWWWXXWXWXWXXXXXXXXXXWWXWXW
WXXXWXWXXWWWWWXXWWXXXXWXWXXWWXXXXXWWWWWXXWWXWWXXXWWXWWXXWXWXXWWXWXXXWXXXWWXXXWXWXWWXWWWWWWWWWWXXXXXW
WWXXXWXWWXXXXWWWXXXXWXXWXWWWXXXWXWWXXXWWXXXXXWXXWXXWWWWWWXXXWXXXXXWWWXWXWXWWXXWXXWXXXXXXXXWWWXXWWWWW
WWXWXWXXXWXXXXXWWXXWXWXWWWXXXWWWWXWWXXWXXWWXXWWXXXWXXWXXXXXXXWXXWXWWXXWXXXWXXWXXXXWWWWWWXXXWXXXWXWWW
WXWXXWWWXXWWXXXWXXWXXWWXWWXXXWXXXXXWXWWWWXXHXXXXWXWXXXWXXWXXWXWWXXWXWWXXWWXWWWXXXXWWXWWWWWXWWXXXWXWW
WXWXXWXWXXXXWXXWXXWWXXWXXXWXXWWWXWXXXXXXWWWXXXWXXWXXWXWXXWXXXWXXWXWWXXXXXXXXXXWXWXXXXXWWXXXXXWXWXWWW
WXWXWXXWXWWXXXXXWXXWXXXXXWWXXXWXXXXXWWWXXWWWXXWWXXXXWXXXXWXXXXXWXXWWXXXXXXXXWXXXXWWWWXXWWXXWXXWWXXXW
WXXWXXXWXXXXXWWWWXWXXWXXXWWXXXWWXXWXWXWXXXXWWXXXXXXXXXXXWXWWWXXXWWWXXWWXXXWXXXWXXXWXXXXWXXXXWXWXWXXW
WXWXXXXWXXXXXWWWXWWWXXWWWXWXXWXWWWXXWWXXXXWWWXWWWWXWXXXXXXXWWWXXXWXWXWXWXXXXXWXXWWXWXXXXXXXWXXWWWXXW
WXWWWXXXXXXXXWWWXWWXXXXXXWXWXWXWWXXXXXWXXXXXXWWXXXXXWXWXWXWXWWWWWXXWXXXXXXXXWWXXXXXXXWXXXXXXXXXXXWXW
WXXXXWXWXWWXXXXXXXXXWXXXWWXXWWXWXWWWWWWWXXWXWXWWXXXXXWWWXXXXXXWXXXXWWWWWXXXXWXXWXXXXWWXWWWXWXXXXXXWW
WWXXWWXWWXXXXXXXXWXXXXXWXWWXWWWXWXXWWWWXWXWXXWWXXXXXXWXXXXXWWXXXXXWWWXXWXWWXXXWXWXWWXXXXXXXWWWWXWXWW
WXXWXXWXWWWWWXXWXXXWXXWWXXXWXXXWWXWXXXWXWWXXXXXXXXWWXWXXWXXXXWXXWXXWXWWXXWWXXWXWWWXWWXWXXWXWXWWWWXWW
WWXXXWWXWWXWXXXXXWXWXWXWXWWWXXXXXXXXXXXXXXWWXWWWWWXWXXWXWXXXWXXWWWWXXXXXXWXXXXWXXXWXXXXWWWWXWWXWXXXW
WWXXXXWWXWXXXXWXXXXWWXXXWWXXXWWWXXXXWXXXXXXXWXXXXXXWWWXXWXXWWXXXWXXWWWXXXWXXWWXXWXXWXWXXXWXXXXXXXXXW
WWXXXXXXXXXXXXXWXXXWXXXXXXWXWXWWXWWWWWXXXXWXXWWWWWWXWXXXXWXWXXXXXXWXXWXWWWXWXXXXWXWWXWXWXXXWWWXWXXWW
WXWXWXXWWWXXXXXXXWXXWXXWXXXXWXXXXWXXWXXXXXXXWWXWWWWWXXXXWXWXXXWWXXWWWWWXXXXWXXXWXXXWWXXXXXWWWWWWWXXW
WXXXWXXXWWXXXWXWXWXXWXXWXWXWXXXXXXXWXXXWWWXXWXXXWWXXWXWWXWXWXXWXXXWXWWXXXWXWXWWWXXWXWXXWXWWWXXXXXXXW
WXWXWXXXXXWXXXXWXXXWWXWWWWWWXWXXWWXXWXXWWXXWXXXWXXXWXWXXXXWXXWXXXXXXWXXWXXXWXXXXWWXWWXXXWWWXWXWXXWXW
WXXWXXWXWWXWXXXWXXXXWWWXWXXXXXXWXXWXWXWXXXXXXXXXWWXXXXXXWXXWXXWXXXXXWWWWWXWXXWWXXXXWXWWXXWXWXWWXWXXW
WXWWXWXWXXXXWWXXWXXWXXWXWWXXXWXWWWWXXWXXWWXWXXXWWXWWXXXWWXXWXXXWWXXWWWXWXWWWXXXXXXWXXWWWXXXXWXXWXWXW
WWWWXWXWWWXWXWXWXXXXXXXXWWXXWWXWXWWXWWWXXXWXWWXWWWXWWWXWXXXXXWWXWXXXWWXXXWWWXXWWXWWXXXXXXWXXWWXXWXWW
WWXWXXXWXXXWXWXWXXWWWWXXWXXXWXXWWXXXWWWXWXXWWXXXXXXXXXXXWWXXWXXXXWXXXXXXWXXWXWXWWWWWWWXXXXXXXXWXXXWW
WWWXXWXWWXXXXXXWWXXWXWWXXWWXXXWXWXXXXXXWXWXWXXXXXXWXXXWWXXXWWXWWXWWXWXXXXXXXXWWWWXXWXXXWXXXXXXXXXXXW
WXXXXXWWWWWXWXXWWWXWXXXXWXXXWWXXWXWWXXXXXWWWXWXWWXXXWWWWXXWWXXWXXWXXWWXWWWXWXWWXXWWWWXXWXXWWWXWXWXXW
WXXXXWWXWXWXXXXXXXXXXXXWXXXXXWXXXWWXWXXWXXWWWXWWXXXWWXXXXWXWWXXWXWXXWXXXXWWXWXXXXXXXXWXXXXWXXXWXWWXW
WXXXWWXWXWXXXWXWWWXXXXWXXWWXXXWXWWXXXWWWXXWXXXXWXWXXWWWWXXWXWXXXXXWWXWWWWWXXWXWXXXXWWXWWXXWXXWXXWXXW
WWXXXXWXXXXXXWWXWWXXWXXWXXXWWXWXXXWXXXXXWXWXXWXWXXWXXWWXXWXXXWWXWWXWXXXXXWXXXWWWXXWWWWWXXWWXXXWWWWXW
WXWXXWXXXXXXXWXXWXWXXXXXXWWXXXWXXWXXXWWWXXWXXXXXXXWXXXXWXXXXXWXXXXXXXWWWXWXXXXWXWWWXWXXXWXXXXXXXWWXW
WXWXWXXXWXXXWXXXXWWXXXXXWXWXXXXWXWXXXXXXXXWXWXXWXWWXWXXXXWWWWWXWXXXXXXXWXXWXWWXWWXXXXXWXXXWWWXWWXXWW
WWWXXXWWXXXXXXWWXXXXXXXWXWXXWXXWXWXWXXXWWXXXWWWXXXWWXXWXWWXXXXXXXXXXWXWXXXWWXXXWWXXXXWWXWXXXWWXXXXWW
WWXXXXWXXWXWXXXXXXWXXWWXXXXXXXXXWWXXXWXXXWWWXXWXWWWWXWWWXWXXXXXXWWWXWWWXXXXWXWXXXXXXXWWXXWXXWXXXWWXW
WWWWXXXXXWXXXWXXWWXXWWXWXWWXXXWWXXXXXWWXXXWXWWWXXWXXXXXXWWWXWXXXXWWWXWXXWWXWXXWWXXWWXXWXWXWWWXXWWXWW
WXXXWWXWXWXXWXXXXXWXWWXXXXWXXXWWXWWWWXXXXXWWXXWWXXWXWWWWWXXXXXWWXXXXXWXXWXWXXWXWXWXXWWXXXXXXXXXXWWXW
WXXXXXXXWXXXXXXWXXXWWXXXXXWXWWWXXWWXXXXXXXXXXXXXXXXWWXXXWXXXXXWXXWXXXXWXWWXXXXXWWXWXXWXXWXXXWXWWXXXW
WWXWWXXXXWXXWXXXXXWXXXWWWXWWXWWWWXWXXXWXXWWWXXWXWXWWWXXXXWXXXWXXXWXXWWXXXXXXXXXWXXWXWWWXWXXWXWXXWWXW
WXWXWWWWXWXXXXWWXXXWXWXWWXXXXXXXXWWXXWXXXWXWXXXWWXWXXWXXXXXXXXWXXXWXWWXXXWWXWWWXXXXXXXWXXXWXXWWWWXWW
WWXXXWWWXWXXXXXWXXWXXXWWXXWXXWXWWWXXWXWXXWXXXXWXXXWXWWXXWXXWXXWXWXXXWWXWXXXXWWXXXWXXXWXXWXWWWWWWWXWW
WXXXXWXWXXXXXXXXWWXXXWXXXXXWXWWXWXWXWXWXWXWWWWXXXWWXWXXWWXXWXXWXXXWXXXXXXXWXWXXXXWXWXXXXXWXXWXWWXWWW
WWWXWXXWXXWWXXWXXXXWWXXWWWXWXXWXXWXXXXWXWXXXXWXXXXXWXXXXWXWXXXXXWXWWXXXXWWWXXWXWXWXXXWWXWXWWXWWWXWWW
WXXXWXXWWWWXWXXXWXWXXXWXXXXXWWXXWWXXWXWXXXWWXWWWWWXWWXXWWXWXWXXXWXXXXXXWXWXXWXWXXWWXXXXXWWXWXWXWXXXW
WWWXXWWXWXXXXXWXWWXXXXWXXWWXXXXXXXWWXXWXXWXXXXXXXXXWXXXXXWWXXXWWWXWXWXWXWXXWXXXWWWXWWXWXXWWXXXWXWXXW
WXXXXWXXWWXXXXXXXXWXXXXWXWXXXWXWXWWXXXXXXXWWXXWXWXWWWWXXWXWWWWXWXXXXWWWWWXXWWXXXWXXXXXWXWXWXXWXXXWXW
WWXXXWWXWXWXXWWXXWXWXWXXXXWXXXWWXXXXWWXXWXXWWWWXXXXWXXWWXWWWXXXXXXXXXWXWXXWXXXXWXWXWWXXWWXXXXXXXXWXW
WXXXXXWXWWXXWXWXXWXWXXWWXWWXXWXWXXXWXXXXWXWXXXWWXWWXXXWXXXWWXXWXXXWWXXWXWXXWWXXWWWXXWXXWXXWXXXXXXWXW
WXXWWXXXXXXWXWXXXXWWXXWXWXXWXXWXWXXWWXWXWWXWXXXXXWXXXWXXWXWXXXXXXXWWXXWXXXWWXXWXWXXWXWWWXWXWWWXWXXXW
WXXWWWXXWWWXXWXXXXXXWWXXXXWWXXXWWWXXXWWWXXWXXXXXWXXXXWWWXWWWXXWXXXXWXXWXXXWXXXXXWXXXWXXXXWWXWWWXWXWW
WWXWWXXWXWXXXWWXXXXWXXWXXXWXXWXXWWWXXXWXWXXWWXWWXXWXWXWWXXWWXWXXXXXWXWXXXXWXWWXWXWWXXXXWXXXXWXXXWWXW
WXWXXWXXXWXXWWXXWXXWXXXXWWWXXXXXWWXWXXWXWXXWXXWXXXXXWXXXXXXXWXWXXXXXWXXWXWXXWXXXXXXWWWXXXWXWWWWWWWXW
WXXXXXWWXWWXWXXWWXXWXXWXWXXXWWWXXXXWXXXWXXWXXWWXXXXXWXXXXXWXXXXWWXXWWWXXXXWXXXXWXXXXXXWXXWXXXWWXXWXW
WWWWWWXWXWWWXXXXXXXXWXXXXXXWXXWWXXXXWWXXWXXXWWXWWWWWWWXXXXXXXWXXXXWXXWWXXWXXXXXXXWWWXXWXXXWXXWXXXXWW
WXWWXXXWXXXXWXXXWXXXXXXXXWXXXXWXXWWWXXXXWWWWWWXXWWWXXWWXWWXWWXXWWXXWWWXXXWXXXXWWWXXWXXXWXWWWXXXWXWXW
WXXXXXXXXXWXXXXWXXWXXWWWXXWXWWWWWXWXWWXWWXWXWWWXXXXXWWXXWWXXXXXWWXWXXWXXXXXXXWWWXXWWXWWWWXWXWWXXXXXW
WXWXXWWXXWWXWXXXXWXXWWXXWWWWXXWWXXXXXWXXXXXWWXWWXXXXWWXWWXXWXWXXXWWWXXXXXXXWWXWXXXWWXXXWXWWXWXWXWWXW
WXWXXWXWWXXWWWXXXXWXXXXXXWXXXWWXXWXXXXXWXXXWWWXWWXWXXXWXXWWXXWXWWXWXWXWWWWWWXXXXWXXXWWXWXXXXXWWXXXXW
WXXXWWXXXXWXXXWXXXXXWXXWWXXXWWXXXWXXXXWXXXWWWXXXWXXWWWXWWXXXWXWWXWWXWXWXXXXXXXWXXWWXXXWWWWWWXXWXXXXW
WXXXXWXWXWWWWWXWXWXWWXXXWXXWXWXXXXWXWXXXWXXXXWWWXXWXWWXXWWXWWWWXWXXWWXWXWXWWXXXXXXWXXXXXXWWWXWWXXXWW
WWXXWXXXXXXXXWXWWXWWWXXXXWWXXXXWWWXXWWWXXWWXWXXXXXWXXWWWXXXXXXXWWXXXXWWXXWXWXXXWXWXXXWWWXWXXWXWXWXWW
WWWXXWXXXXXXXWWXWXWXXWWXWWXXXWWXWXXXWWWWXWXWWXWXXXXWXXWWWWXWWWXXWXWWXWXXWXXWWXXXXXWXWXXWWXXXXXWXWWWW
WWXXXWWWXXWWXXXXXWXWXXWXXXWXWXXXXWXXXWWWXXWXXXXWWXXXXXXXXXWXWXXXWWXXWWXWWXWXXXXWXWWXXXXWXWXXWXWXXWWW
WXXXXXWXWWXXXXXXWWWXWWXXXWWXXXXXXWXWWXXXXWXWXXWWWWWWXXWXXXWXXXWWXXXXWWWXXXWWWXWWXXWWXXXXXXWXXWXXXWWW
WXXXWXWXXXXXXXWXXXXXXWXWWXXXWXXXWXXXWWWWXXXXWWXWXWWXXWXXXXXWXXXWXXWXXXXXWWWXXXXWWXXXXXXXXXXXXXXWWWXW
WXWXXXXWXXWXWWWXXXXWXXXXXWWWXXXXXXWWXXXWWXWXXXXXXXXXXXWXXWXWXXXXWXXWXXXXWXXWWXWXXXXWWWWXWWXXXXWXXWXW
WXWXXWWWWXXXXXXXWWWWXXWXXXXWXXWWWXXXXXWWXXWWWXWXXWXXWWWWWWWXXXWXXXWXXXXXWXWXWXWXXWXWWXXXXWXWXXXWXWXW
WXXWXXWWWWXXXXWWXXWWWXXXXWWWXWWXXXXWXXWXXXXWXXXWXWXWXXXXXWXXXXWXXXXWXWXWXWXWXWXWXXXXXXXXXXXWWXWXXXWW
WWXWWWXWXXXXWXWWXXXWXWXWXWXWXWWXXXWXXWWWXXXXWXWXWXWWXXWXWWXXXXXWWXXXWXWWWXXXWXXXXXWXWWWXWXXWXWWXWXXW
WWXWWWWXXXXXXWWXWXXWXXXWWWXWXXXWWXWXXXXWXWXXXXXXXWXXXXWXWWWWXXWWXWXXWXXXWXXWXWWXXXWWXXXXWXXWWWWWXXWW
WXXXXXXXXXXXXWXWWXXWWWXWWXXWWWXXWWXXXXXXXXXXXXWXWXXWWWWWWXWWXXXWXWXWWXWWXWWWWXXWXXWXXXWXXWXXWWWWXXWW
WWXWXXXWWXXXWXXXWXXXWWXXWWWWWWXWXXWWXXXWWXWXXXWXXXWXXWXXXWWXXWWXWXWXWWXWXXXWXWXXXWWXXWWWWXWWWWWXXXXW
WXWWXXXXXWWXXXWWXWXWXXWXWXXWXXWXWWXXXWWWXWWWXXXXXWXWXWWXWXWWXXXXXXXWXXWXXXXXXXXXXWWXXWXXXXXXXXWWXXXW
WWWWWWXXWWXWXXWXXWWWXXXXWXXXXWXWXXXWWWWXWXXXXXWXWXWXWXWXWXWXXWXWWXXXXXWXXXXWXWXXXWWXWXXWXXXWXXXXXXXW
WWWWWXXXXXXXWWXXWXWXWXWXXXXWWWXXWWWWXXWXXWXXWWWWXXXWXWXWXXWXWXWWXWXXXXXXWXXXXWXWWXWXXXXWXXWWXWXXXXXW
WWXXWXWWWXXXXWWXXWXWXXXWWWWWWXXXXWWXXXWXXWWXXWXWXWXXXWXXXXXXWXXWXWWXWXWWXXXXXXXXWXWWWWWXWXXWWXXWXWWW
WXXWWWWXWXWWXXWXWXWXXWWWXXWWWWXXXWXWXWXXWXXWWXXXWXWXXWXXWWXWWWXXXWXXWXWXXWWXXXXXXWXXXXXWXWWXWXXXWXWW
WWWXXXXXWXXXXXWXXWXXXWWWXWWXXWWWXXXXXWXWWWXWWXXWXXXXWWWWXXWXXXXXWXXXXWXWXXWWXXXWXWXWXXXXXXXXWXXXXWXW
WXWXXWXWXXXXWWXWWWXWXWXWWXXWWWWWXWXWXWXWXWXWXWXWWXWWWWXXWXXWXWWWWWXWXXWXXXXWWWXXWXWWXXXXWWXXXWXWWXWW
WXWWXXXWXWXXWXXXXXWXXXXXWXXXWXXWXXXXWXXXXXXXXWXXXXXXXXXXXXXXXXXXWXWXWWXWXXWWWWXXXXXXXWXXXWWXXWXXXXWW
WWWWWWXWXXWXXWXXWWXWXXXXWXWWXXXWXXWXXXWWXWWXXXWWXWXXWWWWWXWXWXXXWWXXWXXXXXXWWWWXXXXWWWXWWXXWXXXWXXXW
WXXXXXXXXWXXXWXXXXWXXWXXWXWWXWXWWXWXWWXWXWXXXWXXWWWWWXXWXWXXXWXWXXXXWXXXXWWXXXXWXWWXXXWWWWWXXXXWXWXW
WWXXWWWXWWXXXXWXXWXXXXXWXXWXWXXXXXWWWXWWXXXXWWXWXWXXXWXXWWWWXXXXXXXXWXXXXWWWXWWXXXXWXXXXXWWWXWXXXXXW
WXXXWWWXWXXWXXWWXXWWXXWXXXXWXXXXWXXWWXXXWWXWWXXXXXXXXWWWXXWXXWXWXXXXXXXWWXXXXWXXWXXXXXWWWXXXWWXXWWWW
WWXWWWWWXXXXXXXXWWWXXXXXXWXXXXXWXXXXXWXWWXWXXXXXXXXXXWXXXWWWWXXXXXXXXWWXXXXXWXWXXWWWWXXXXXWXWXXXWXXW
WWWWWXXWXXWWXXWXXXXXXWXXWWWXXXXXXXWXXXWWXWXXXWXWXXXXXWWWXXXWWWXWXXXXWXWXXXWWXXXXXWXWXXWXWWWWXWXWWXXW
WXXXXXXXWXXXXWWXWXXWXWWWWWXWXXWXXWWXXXXWWWXXXWXXXWXXWXXXWXWXWXXXXWXWXXXXXXWWWXXXXXWXXXWXWXWXWXXXWXWW
WWWWWWWWWWWWWWWWWWWWWWWWWWWWWWWWWWWWWWWWWWWWWWWWWWWWWWWWWWWWWWWWWWWWWWWWWWWWWWWWWWWWWWWWWWWWWWWWWWWW
