21 21
WWWWWWWWWWWWWWWWWWWWW
WXXXXXXXXXXXXXXXXXXXW
WXXXXXXXXXXXXXXXXXXXW
WXXWWWWWWXXXWWWWWWXXW
WXXWSSSXXXXXXXXXXWXXW
WXXWSSSNLXXXXXXXXWXXW
WXXWXXXXXXWXXXXXXWXXW
WXXWXXXHXXWXXDDXXWXXW
WXXXXXXXXXWpmrbXXWXXW
WXXXXXXXXWWWXXXXXXXXW
WXXXXXWWWWWWWWWXXXXXW
WXXXXXPMRWWWXXXXXXXXW
WXXWXXXXBXWXXXXXXWXXW
WXXWXXXXXXWXXXXXXWXXW
WXXWXXXXXXWXXXXXXWXXW
WXXWXXXXXXXXXXXXXWXXW
WXXWXXXXXXXXXXXXXWXXW
WXXWWWWWWXXXWWWWWWXXW
WXXXXXXXXXXXXXXXXXXXW
WXXXXXXXXXXXXXXXXXXXW
WWWWWWWWWWWWWWWWWWWWW
