80 108
WWWWWWWWWWOOOOWWWWWWWWWWOOOOWWWWWWWWWWOOOOWWWWWWWWWWOOOOWWWWWWWWWWOOOOWWWWWWWWWW
WXXXXXXXXWOOOOWXXXXXXXXWOOOOWXXXXXXRRWOOOOWXXXXXXXXWOOOOWRXXXXXXXWOOOOWXXXXXXXXW
WXXXXXXXXWOOOOWMXXXXXXXWOOOOWXBXXXXXXWOOOOWXXXXXXXXWOOOOWXMMBMRXXWOOOOWXXXXXXXXW
WXXXXXXXXWOWWWWMXXXXXRXWWWWWWXXXXXXXXWWWWWWXXXXXXXXWWWWWWXXXXXXXXWWWWWWXXXXXXXXW
WXXXXXXXXWOWXSXMXXXXXXXXXXXXXXXXXXXXXXXXXXXXXXXXXXXXXXXXXXXXXXXXXXXXXXXXXXXXXXXW
WXXLSNLXXWOWXXXMXXXXXXXXXXXXXXXXXXXXXXXXXXXXXXXXXXXXXXXXXXXXXXXXXXXXXXXXXXXXXXXW
WXXXXXXXXWOWWWWMXXXXXRXWWWWWWXXXXXXXXWWWWWWXXXXXXXXWWWWWWXBMBMXXXWWWWWWXXXXXXXXW
WXXXXXXXXWOOOOWXXXXXXXXWOOOOWXBXXXXXXWOOOOWXXXXXXXXWOOOOWXXXXRXXXWOOOOWXXXXXXXXW
WXXXXXXXXWOOOOWXXXXXXXXWOOOOWXXXXXXRRWOOOOWXXXXXXXXWOOOOWXXXXXXXXWOOOOWXXXXXXXXW
WWWWXXWWWWOOOOWWWWXXWWWWOOOOWWWWWWWWWWOOOOWWWWXXWWWWOOOOWWWWXXWWWWOOOOWWWWXXWWWW
OOOWXXWOOOOOOOOOOWXXWOOOOOOOOOOOOOOOOOOOOOOOOWXNWOOOOOOOOOOWXXWOOOOOOOOOOWXXWOOO
OOOWXXWOOOOOOOOOOWXXWOOOOOOOOOOWWWWOOOOOOOOOOWXXWOOOOOOOOOOWXXWOOOOOOOOOOWXXWOOO
OOOWXXWOOOOOOOOOOWXXWOOOOOOOOOOWXXWOOOOOOOOOOWWWWOOOOOOOOOOWXXWOOOOOOOOOOWXXWOOO
OOOWXXWOOOOOOOOOOWXXWOOOOOOOOOOWXXWOOOOOOOOOOOOOOOOOOOOOOOOWXXWOOOOOOOOOOWXXWOOO
WWWWXXWWWWOOOOWWWWXXWWWWOOOOWWWWXXWWWWOOOOWWWWWWWWWWOOOOWWWWXXWWWWOOOOWWWWXXWWWW
WXXXXXXXXWOOOOWXXXXXXXXWOOOOWXXXXXXXXWOOOOWXXXXXXXXWOOOOWXXXXXXXXWOOOOWXXXXXXXXW
WXXXXXXXXWOOOOWXXXXXXXXWOOOOWXXXXXXXXWOOOOWXXXXXXXXWOOOOWXXXXXXXXWOOOOWXXXXXXXXW
WXXXXXXXXWOWWWWXXXXXXXXWWWWWWXXXXXXXXWWWWOWXXXXXXXXWWWWWWXXBXXBXXWOWWWWXXXXXXXXW
WXXXXXXXXWOWXXXXXXXXXXXXXXXXXXXXXXXXXXSXWOWXXXDDXXXXXXXXXXXXXXXXXWOWXXXXXXXXXXXW
WXXXXXXXXWOWXNXXXXXXXXXXXXXXXXXXXXXXXXXXWOWXXXXXXXXXXXXXXXXXXXXXXWOWXXXXXXXXXXXW
WXXXXXXXXWOWWWWXXXXXXXXWWWWWWXXXXXXXXWWWWOWXXXXXXXXWWWWWWXXBXXBXXWOWWWWXXXXXXXXW
WXXXXXXXXWOOOOWXXXXXXXXWOOOOWXXXXXXXXWOOOOWXXXXXXXXWOOOOWXXXXXXXXWOOOOWXXXXXXXXW
WXXXXXXXXWOOOOWXXXXXXXXWOOOOWXXXXXXXXWOOOOWXXXXXXXXWOOOOWXXXXXXXXWOOOOWXXXXXXXXW
WWWWXXWWWWOOOOWWWWXXWWWWOOOOWWWWXXWWWWOOOOWWWWWWWWWWOOOOWWWWWWWWWWOOOOWWWWXXWWWW
OOOWXXWOOOOOOOOOOWXXWOOOOOOOOOOWXXWOOOOOOOOOOOOOOOOOOOOOOOOOOOOOOOOOOOOOOWXXWOOO
OOOWXXWOOOOOOOOOOWXXWOOOOOOOOOOWXXWOOOOOOOOOOWWWWOOOOOOOOOOWWWWOOOOOOOOOOWXXWOOO
OOOWXXWOOOOOOOOOOWXXWOOOOOOOOOOWXXWOOOOOOOOOOWXXWOOOOOOOOOOWXXWOOOOOOOOOOWXXWOOO
OOOWXXWOOOOOOOOOOWXXWOOOOOOOOOOWXXWOOOOOOOOOOWXXWOOOOOOOOOOWSXWOOOOOOOOOOWXXWOOO
WWWWXXWWWWOOOOWWWWXXWWWWOOOOWWWWXXWWWWOOOOWWWWXXWWWWOOOOWWWWXXWWWWOOOOWWWWXXWWWW
WXXXXXXXXWOOOOWXXXXXXXXWOOOOWXXXXXXXXWOOOOWXXXXXXXXWOOOOWXXXXXXXXWOOOOWXXXXXXXXW
WXXXXXXXXWOOOOWXXXXXXXXWOOOOWXXXXXXXXWOOOOWXXXXXXXXWOOOOWXXXXXXXXWOOOOWXXXXXXXXW
WXXXXXXXXWWWWWWXXXXXXXXWOWWWWXXXXXXXXWOWWWWXXXXXXXXWWWWWWXXXXXXXXWWWWOWXXXLXLXXW
WXXXXXXXXXXXXXXXXXXXXXXWOWXLXXXXXXXXXWOWXXXXXXXXXXXXXXXXXXXXXXXXXXXXWOWXXXXSXXXW
WXXXXXXXXXXXXXXXXXXXXXXWOWXXXXXXXXXXXWOWXXXXXXXXXXXXXXXXXXXXXXXXXXXXWOWXXXNXLXXW
WXXXXXXXXWWWWWWXXXXXXXXWOWWWWXXXXXXXXWOWWWWXXXXXXXXWWWWWWXXXXXXXXWWWWOWXXXXXXXXW
WXXXXXXXXWOOOOWXXXXXXXXWOOOOWXXXXXXXXWOOOOWXXXXXXXXWOOOOWXXXXXXXXWOOOOWXXXXXXXXW
WXXXXXXXXWOOOOWXXXXXXXXWOOOOWXXXXXXXXWOOOOWXXXXXXXXWOOOOWXXXXXXXXWOOOOWXXXXXXXXW
WWWWXXWWWWOOOOWWWWXXWWWWOOOOWWWWXXWWWWOOOOWWWWXXWWWWOOOOWWWWXXWWWWOOOOWWWWWWWWWW
OOOWXXWOOOOOOOOOOWXXWOOOOOOOOOOWXXWOOOOOOOOOOWXXWOOOOOOOOOOWXXWOOOOOOOOOOOOOOOOO
OOOWXXWOOOOOOOOOOWXXWOOOOOOOOOOWXXWOOOOOOOOOOWXXWOOOOOOOOOOWXXWOOOOOOOOOOWWWWOOO
OOOWXXWOOOOOOOOOOWXXWOOOOOOOOOOWXXWOOOOOOOOOOWXXWOOOOOOOOOOWXXWOOOOOOOOOOWXXWOOO
OOOWXXWOOOOOOOOOOWXXWOOOOOOOOOOWXXWOOOOOOOOOOWXXWOOOOOOOOOOWXXWOOOOOOOOOOWLXWOOO
WWWWXXWWWWOOOOWWWWXXWWWWOOOOWWWWXXWWWWOOOOWWWWXXWWWWOOOOWWWWXXWWWWOOOOWWWWXXWWWW
WXXXXXXXXWOOOOWXXXXXXXXWOOOOWXXXXXXXXWOOOOWXXXXXXXXWOOOOWXXXXXXXXWOOOOWXXXXXXXXW
WXXXXXXXXWOOOOWXXXXXXXXWOOOOWXXRXXRXXWOOOOWXXXXXXXXWOOOOWXXXXXXXXWOOOOWXXXXXXXXW
WXXXXXXXXWWWWWWXXXXXXXXWWWWWWXXXXXXXXWWWWWWXXXXXXXXWWWWWWXXXXXXXXWWWWWWXXXXXXXXW
WXXXXXXXXXXXXXXXXXXXXXXXXXXXXXXBXXXXXXXXXXXXXXXXXXXXXXXXXXXXXXXXXXXXXXXXXXXXXXXW
WXXXXXXXXXXXXXXXXXXXXXXXXXXXXXXXXXBXXXXXXXXXXXXXXXXXXXXXXXXXXXXXXXXXXXXXXXXXXXXW
WXXXXXXXXWWWWWWXXXXXXXXWWWWWWXXXXXXXXWWWWWWXXXXXXXXWWWWWWXXXXXXXXWWWWWWXXXXXXXXW
WXXXXXXXXWOOOOWXXXXXXXXWOOOOWXXMXXMXXWOOOOWXXXXXXXXWOOOOWXXXXXXXXWOOOOWXXXXXXXXW
WXXXXXXXXWOOOOWXXXXXXXXWOOOOWXXXXXXXXWOOOOWXXXXXXXXWOOOOWXXXXXXXXWOOOOWXXXXXXXXW
WWWWXXWWWWOOOOWWWWXXWWWWOOOOWWWWXXWWWWOOOOWWWWWWWWWWOOOOWWWWXXWWWWOOOOWWWWXXWWWW
OOOWXSWOOOOOOOOOOWXXWOOOOOOOOOOWXXWOOOOOOOOOOOOOOOOOOOOOOOOWXXWOOOOOOOOOOWXXWOOO
OOOWXXWOOOOOOOOOOWXXWOOOOOOOOOOWXXWOOOOOOOOOOWWWWOOOOOOOOOOWXXWOOOOOOOOOOWXXWOOO
OOOWWWWOOOOOOOOOOWWWWOOOOOOOOOOWXXWOOOOOOOOOOWXXWOOOOOOOOOOWXXWOOOOOOOOOOWXXWOOO
OOOOOOOOOOOOOOOOOOOOOOOOOOOOOOOWXXWOOOOOOOOOOWLXWOOOOOOOOOOWXXWOOOOOOOOOOWXXWOOO
WWWWWWWWWWOOOOWWWWWWWWWWOOOOWWWWXXWWWWOOOOWWWWXXWWWWOOOOWWWWXXWWWWOOOOWWWWXXWWWW
WXXXXXXXXWOOOOWXXXXXXXXWOOOOWXXXXXXXXWOOOOWXXXXXXXXWOOOOWXXXXXXXXWOOOOWXXXXXXXXW
WXXXXXXXXWOOOOWXXXXXXXXWOOOOWXXXXXXXXWOOOOWXXXXXXXXWOOOOWXXXXXXXXWOOOOWXXXXXXXXW
WXXXXXXXXWWWWWWXXXXLXXXWWWWOWXXXXXXXXWWWWWWXXXXXXXXWWWWWWXXXXXXXXWWWWOWXXXXXXXXW
WXXXXXXXXXXXXXXXXXNSLXXXXXWOWXXXXXXXXXXXXXXXXXXXXXXXXXXXXXXXXXXXXXNXWOWXXXXXXXXW
WXXXXXXXXXXXXXXXXXXNXXXXXXWOWXXXXXXXXXXXXXXXXXXXXXXXXXXXXXXXXXXXXXXXWOWXXXXXXXXW
WXXXXXXXXWWWWWWXXXXXXXXWWWWOWXXXXXXXXWWWWWWXXXXXXXXWWWWWWXXXXXXXXWWWWOWXXXXXXXXW
WXXXXXXXXWOOOOWXXXXXXXXWOOOOWXXXXXXXXWOOOOWXXXXXXXXWOOOOWXXXXXXXXWOOOOWXXXXXXXXW
WXXXXXXXXWOOOOWXXXXXXXXWOOOOWXXXXXXXXWOOOOWXXXXXXXXWOOOOWXXXXXXXXWOOOOWXXXXXXXXW
WWWWXXWWWWOOOOWWWWXXWWWWOOOOWWWWWWWWWWOOOOWWWWWWWWWWOOOOWWWWXXWWWWOOOOWWWWXXWWWW
OOOWXXWOOOOOOOOOOWXXWOOOOOOOOOOOOOOOOOOOOOOOOOOOOOOOOOOOOOOWXXWOOOOOOOOOOWXXWOOO
OOOWXXWOOOOOOOOOOWXXWOOOOOOOOOOWWWWOOOOOOOOOOWWWWOOOOOOOOOOWXXWOOOOOOOOOOWXXWOOO
OOOWXXWOOOOOOOOOOWWWWOOOOOOOOOOWXXWOOOOOOOOOOWXXWOOOOOOOOOOWXXWOOOOOOOOOOWXXWOOO
OOOWXXWOOOOOOOOOOOOOOOOOOOOOOOOWXXWOOOOOOOOOOWXXWOOOOOOOOOOWXXWOOOOOOOOOOWXXWOOO
WWWWXXWWWWOOOOWWWWWWWWWWOOOOWWWWXXWWWWOOOOWWWWXXWWWWOOOOWWWWXXWWWWOOOOWWWWXXWWWW
WXXXXXXXXWOOOOWXXXXXXXXWOOOOWXXXXXXXXWOOOOWXXXXXXXXWOOOOWXXXXXXXXWOOOOWXXXXXXXXW
WXXXXXXXXWOOOOWXXXXXXXXWOOOOWXXXXXXXXWOOOOWXXXXXXXXWOOOOWMXXXXXXXWOOOOWXXXXXXXXW
WXXXXXXXXWWWWOWXXXXXXXHEOWWWWXXXXXXXXWWWWWWXXXXXXXXWWWWOWMXXXXXXRWWWWWWXXXXXXXXW
WXXXXXXXXXXXWOWXXXXXXXXWOWXXXXXXXXXXXXXXXXXXXXXXXXXXXXWOWMXXXXXXXXXXXXXXXXXXXXXW
WXXXXXXXXXXXWOWXXXXXXXXWOWXXXXXXXXXXXXXXXXXXXXXXXXXXXXWOWMXXXXXXXXXXXXXXXXXXXXXW
WXXXXXXXXWWWWOWXXXXXXXXWOWWWWXXXXXXXXWWWWWWXXXXXXXXWWWWOWMXXXXXXBWWWWWWXXXXXXXXW
WXXXXXXXXWOOOOWXXXXXXXXWOOOOWXXXXXXXXWOOOOWXXXXXXXXWOOOOWMXXXXXXXWOOOOWXXXXXXXXW
WXXXXXXXXWOOOOWXXXXXXXXWOOOOWXXXXXXXXWOOOOWXXXXXXXXWOOOOWXXXXXXXXWOOOOWXXXXXXXXW
WWWWXXWWWWOOOOWWWWXXWWWWOOOOWWWWXXWWWWOOOOWWWWXXWWWWOOOOWWWWXXWWWWOOOOWWWWXXWWWW
OOOWXXWOOOOOOOOOOWXXWOOOOOOOOOOWXXWOOOOOOOOOOWXXWOOOOOOOOOOWXXWOOOOOOOOOOWXXWOOO
OOOWXXWOOOOOOOOOOWXXWOOOOOOOOOOWXXWOOOOOOOOOOWXXWOOOOOOOOOOWXXWOOOOOOOOOOWXXWOOO
OOOWXXWOOOOOOOOOOWXXWOOOOOOOOOOWXXWOOOOOOOOOOWXXWOOOOOOOOOOWXXWOOOOOOOOOOWXXWOOO
OOOWXXWOOOOOOOOOOWXXWOOOOOOOOOOWXXWOOOOOOOOOOWXXWOOOOOOOOOOWXXWOOOOOOOOOOWXXWOOO
WWWWXXWWWWOOOOWWWWXXWWWWOOOOWWWWXXWWWWOOOOWWWWXXWWWWOOOOWWWWXXWWWWOOOOWWWWXXWWWW
WXXXXXXXXWOOOOWXXXXXXXXWOOOOWXXXXXXXXWOOOOWXXXXXXXXWOOOOWXXXXXXXXWOOOOWXXXXXXXXW
WXXXXXXXXWOOOOWXXXXXXXXWOOOOWXXXXXXXXWOOOOWXXXXXXXXWOOOOWXXXXXXXXWOOOOWXXXXXXXXW
WXXXXXXXXWOWWWWXXXXXXXXWWWWWWXXXXXXXXWWWWWWXXLXXNXXWWWWOWXXXXXXXXWWWWWWXXXXXXXXW
WXXXXXXXXWOWXXXXXXXXXXXXXXXXXXXXXXXXXXXWWXXXXXXSXXXXXXWOWXXXXXXXXXXXXXXXXXXXXXXW
WXXXXXXXXWOWXXXXXXXXXXXXXXXXXXXXXXXXXXXWWXXXXXNXXXXXXXWOWXXXXXXXXXXXXXXXXXXXXXXW
WXXXXXXXXWOWWWWXXMXXMXXWWWWWWXXXXXXXXWWWWWWXXLXXLXXWWWWOWXXXXXXXXWWWWWWXXXXXXXXW
WXXXXXXXXWOOOOWXXXXXXXXWOOOOWXXXXXXXXWOOOOWXXXXXXXXWOOOOWXXXXXXXXWOOOOWXXXXXXXXW
WXXXXXXXXWOOOOWXXXXXXXXWOOOOWXXXXXXXXWOOOOWXXXXXXXXWOOOOWXXXXXXXXWOOOOWXXXXXXXXW
WWWWXXWWWWOOOOWWWWXXWWWWOOOOWWWWXXWWWWOOOOWWWWXXWWWWOOOOWWWWXXWWWWOOOOWWWWXXWWWW
OOOWXXWOOOOOOOOOOWXXWOOOOOOOOOOWXXWOOOOOOOOOOWXXWOOOOOOOOOOWXXWOOOOOOOOOOWXXWOOO
OOOWXXWOOOOOOOOOOWXXWOOOOOOOOOOWXXWOOOOOOOOOOWXXWOOOOOOOOOOWXXWOOOOOOOOOOWXXWOOO
OOOWXXWOOOOOOOOOOWXXWOOOOOOOOOOWWWWOOOOOOOOOOWWWWOOOOOOOOOOWXXWOOOOOOOOOOWXXWOOO
OOOWXXWOOOOOOOOOOWXXWOOOOOOOOOOOOOOOOOOOOOOOOOOOOOOOOOOOOOOWXXWOOOOOOOOOOWWWWOOO
WWWWXXWWWWOOOOWWWWXXWWWWOOOOWWWWWWWWWWOOOOWWWWWWWWWWOOOOWWWWXXWWWWOOOOWWWWWWWWWW
WXXXXXXXXWOOOOWXXXXXXXXWOOOOWXXXXXXXXWOOOOWXXXXXXXXWOOOOWXXXXXXXXWOOOOWXXXXXXXXW
WXXXXXXXXWOOOOWXXXXXXXXWOOOOWXXMXXMXXWOOOOWXXXXXXXXWOOOOWXMXXXXRXWOOOOWXXXXXXWXW
WXXXXXXXXWWWWWWXXXXXXXXWWWWWWXXXXXXXXWWWWWWXXXXXXXXWWWWWWXXXXXXXXWWWWOWXWXXWXXXW
WXXXXXXXXXXXXXXXXXXXXXXXXXXXXXXXXXXXXXXXXXXXXXXXXXXXXXXXXXXXXXXXXXXXWOWXWXXWXWXW
WXXXXXXXXXXXXXXXXXXXXXXXXXXXXXXXXXXXXXXXXXXXXXXXXXXXXXXXXXXXXXXXXXSXWOWXWWWWXWXW
WXXXXXXXXWWWWWWXXXXXXXXWWWWWWXXXBXXXXWWWWWWXXXXXXXXWWWWWWXMXXXXRXWWWWOWXWXXWXWXW
WXXXXXXXXWOOOOWXXXXXXXXWOOOOWXXXXXXXXWOOOOWXXXXXXXXWOOOOWXXXXXXXXWOOOOWXWXXWXWXW
WXXXXXXXXWOOOOWXXXXXXXXWOOOOWXXXXXXXXWOOOOWXXXXXXXXWOOOOWXXXXXXXXWOOOOWXXXXXXXXW
WWWWWWWWWWOOOOWWWWWWWWWWOOOOWWWWWWWWWWOOOOWWWWWWWWWWOOOOWWWWWWWWWWOOOOWWWWWWWWWW
