data/musics/bgmusic.ogg
64 64
OOOOOOOOOOOOOOOOOOOOOOOOOOOWWWEWWWOOOOOOOOOOOOOOOOOOOOOOOOOOOOOO
OOOOOOOOOOOOOOOOOOOOOOOOOOWWXXHXXWWOOOOOOOOOOOOOOOOOOOOOOOOOOOOO
OOOOOOOOOOOOOOOOOOOOOOOOOWWXXXXXXXWWOOOOOOOOOOOOOOOOOOOOOOOOOOOO
OOOOOOOOOOOOOOOOOOOOOOOOWWXXXXXXXXXXWXOOOOOOOOOOOOOOOOOOOOOOOOOO
OOOOOOOOOOOOOOOOOOOOOOOOWXXXWXXXWXXXWXOOOOOOOOOOOOOOOOOOOOOOOOOO
OOOOOOWWWWWWWOOOOOOOOOOWWXXXWXXXWXXXWWOOOOOOOOOWWWWWWWOOOOOOOOOO
OOOOOWWXXXXXWWOOOOOOOOOWXXXXWXXXWXXXXWOOOOOOOOWWXXXXXWWOOOOOOOOO
OOOOOWXXRXXXXWWOOOOOOOOWXXXXXXXXXXXXXWOOOOOOOWWXXXXRXXWOOOOOOOOO
OOOOOWXXXXXXXXWOOOOOOOOWWXXWXXXXXWXXXWOOOOOOOWXXXXXXXXWOOOOOOOOO
OOOOWWXXXXXXXXWWOOOOOOOOWXXXWWWWWXXXWWOOOOOOWWXXXXXXXXWWOOOOOOOO
OOOOWXXXXXXXXXXWOOOOOOOOWWXXXXXXXXXWWOOOOOOOWXXXXXXXXXXWOOOOOOOO
OOOOWXRXXMXMXXXWWOOOOOOOOWWXXXXXXXWWOOOOOOOWWXXXMXMXXRXWOOOOOOOO
OOOOWXXXXXXXXXXXWOOOOOOOOOWXSXXSXXWOOOOOOOOWXXXXXXXXXXXWOOOOOOOO
OOOOWXXMXXMXXMXXWOOOOOOOOOWXXXXXXXWOOOOOOOOWXXMXXMXXMXXWOOOOOOOO
OOOOWXXXXXXXXXXXWOOOOWWWWWWXXXXXXXWWWWWOOOOWXXXXXXXXXXXWOOOOOOOO
OOOOWWXXXXXXXXXXWOWWWWXXXXXXXXXXXXXXXXWWWWOWXXXXXXXXXXWWOOOOOOOO
OOOOOWRXXXXXXXBXWWWXXXXXXXXXXXXXXXXXXXXXXWWWXBXXXXXXXXWOOOOOOOOO
OOOOOWWXXXXXXBXXXXXXXXXXXXXXXXXXXXXXXXXXXXXXXXBXXXXXRWWOOOOOOOOO
OOOOOOWWXXXXBXXXXXXXXXXXXXXXXXXXXXXXXXXXXXXXXXXBXXXXWWOOOOOOOOOO
OOOOOOOWWWWWWXXXXXXXXXXXXXXXXXXXXXXXXXXXXXXXXXXWWWWWWOOOOOOOOOOO
OOOOOOOOOOOOWXXXXXXXXXXXXXXXXXXXXXXXXXXXXXXXXXXWOOOOOOOOOOOOOOOO
OOOOOOOOOOOWWXXXXXXXXXXXXXXXXXXXXXXXXXXXXXXXXXXWWOOOOOOOOOOOOOOO
OOOOOOOOOOOWXXXXXXXXXXXXXXXXXXXXXXXXXXXXXXXXXXXXWOOOOOOOOOOOOOOO
OOOOOOOOOOOWXXXXXXXXXXXXXXXXXXXXXXXXXXXXXXXXXXXXWOOOOOOOOOOOOOOO
OOOOOOOOOOOWXXXXXXXXXXXMXXXXXXLXXXXMXXXXXXXXXXXXWOOOOOOOOOOOOOOO
OOOOOOOOOOOWXXXXXXXXXXXXXXXXXXXXXXXXXXXXXXXXXXXXWOOOOOOOOOOOOOOO
OOOOOOOOOOWWXXXXXXXXXXXXXXXXXXXXXXXXXXXXXXXXXXXXWWOOOOOOOOOOOOOO
OOOOOOOOOOWXXXXXXXXXXXXXXNXXXXXXXNXXXXXXXXXXXXXXXWOOOOOOOOOOOOOO
OOOOOOOOOOWXXXXXXXXXXXXXXXXXXXXXXXXXXXMXXXXXXXXXXWOOOOOOOOOOOOOO
OOOOOOOOOOWXXXXXXXXXMXXXXXXXXXXXXXXXXXXXXXXXXXXXXWOOOOOOOOOOOOOO
OOOOOOOOOOWXXXXXXXXXXXXXXXXBXXXXBXXXXXXXXXXXXXXXXWOOOOOOOOOOOOOO
OOOOOOOOOOWXXXXXXXXXXXXXXXXXXXXXXXXXXXXXXXXXXXXXXWOOOOOOOOOOOOOO
OOOOOOOOOOWXXXXXXXXXXXXLXXXXXXXXXXXLXXXXXXXXXXXXXWOOOOOOOOOOOOOO
OOOOOOOOOOWXXXXXXXXXXXXXXXXXXDDXXXXXXXXXXXXXXXXXXWOOOOOOOOOOOOOO
OOOOOOOOOOWXXXXXXXXXXXXXXXXXXXXXXXXXXXXXXXXXXXXXXWOOOOOOOOOOOOOO
OOOOOOOOOOWXXXXXXXXXXXXXXXXXBXXBXXXXXXXXXXXXXXXXXWOOOOOOOOOOOOOO
OOOOOOOOOOWXXXXXXXXXXXXXXXXXXXXXXXXXXXXXXXXXXXXXXWOOOOOOOOOOOOOO
OOOOOOOOOOWXXXXXXXXXXXXXXXXXXXXXXXXXXXXXXXXXXXXXXWOOOOOOOOOOOOOO
OOOOOOOOOOWWXXXXXXXXXXXXXXXXXXXXXXXXXXXXXXXXXXXXXWOOOOOOOOOOOOOO
OOOOOOOOOOOWXXXXXXXXXXMXXXXXXXXXXXXMXXXXXXXXXXXXWWOOOOOOOOOOOOOO
OOOOOOOOOOOWXXXXXXXXXXXXXXXXXLXXXXXXXXXXXXXXXXXXWOOOOOOOOOOOOOOO
OOOOOOOOOOOWXXXXXXXXXXXXXXXXXXXXXXXXXXXXXXXXXXXXWOOOOOOOOOOOOOOO
OOOOOOOOOOOWWXXXXXXXXXXXXXXXXXXXXXXXXXXXXXXXXXXWWOOOOOOOOOOOOOOO
OOOOOOOOOOOOWXXXXXXXXXXXXXXXXXXXXXXXXXXXXXXXXXXWOOOOOOOOOOOOOOOO
OOOOOOOOWWWWWXXXXXXXXXXXXXXXXXXXXXXXXXXXXXXXXXXWWWWWOOOOOOOOOOOO
OOOOOWWWWXXXXXXXXXXXXXXXXXXXXXXXXXXXXXXXXXXXXXXXXXXWWWWOOOOOOOOO
OOOOWWXXXXXXXBXXXXXXXXXXXXXXXXXXXXXXXXXXXXXXXXBXXXXXXXWWOOOOOOOO
OOOWWXXXXXXXXXBXXXXXXXXXXXXXXXXXXXXXXXXXXXXXXBXXXXXXXXXWWOOOOOOO
OOOWXXXXXXXXXXXBXWWWWWRMMBMMMRRMMBMMMRWWWWWXBXXXXXXXXXXXWOOOOOOO
OOOWXXXXXXXXXXXXXWOOOWWWWWWWWWWWWWWWWWWOOOWXXXXXXXXXXXXXWOOOOOOO
OOOWXXXXXXXXXXXXXWOOOOOOOOOOOOOOOOOOOOOOOOWXXXXXXXXXXXXXWOOOOOOO
OOWWXXXXXXXXXXXXXWOOOOOOOOOOOOOOOOOOOOOOOOWXXXXXXXMXXXXXWWOOOOOO
OOWXXXXXXMXXXXXXXWOOOOOOOOOOOOOOOOOOOOOOOOWXXXXMXXXMXXXXXWOOOOOO
OOWXXXXXMXXXMXXXXWOOOOOOOOOOOOOOOOOOOOOOOOWXXXXXMXXXMXXXXWOOOOOO
OOWXXXXMXXXMXXXXXWOOOOOOOOOOOOOOOOOOOOOOOOWXXXXXXMXXXMXXXWOOOOOO
OOWXXXMXXXMXXXXXXWOOOOOOOOOOOOOOOOOOOOOOOOWXXXXXXXMXXXXXXWOOOOOO
OOWWXXXXXMXXXXXXXWOOOOOOOOOOOOOOOOOOOOOOOOWXXXXXXXXXXXXXWWOOOOOO
OOOWXXXXXXXXXXXXWWOOOOOOOOOOOOOOOOOOOOOOOOWWXXXXXXXXXXXXWOOOOOOO
OOOWXXXXXXXXXXXXWOOOOOOOOOOOOOOOOOOOOOOOOOOWXXXXXXXXXXXXWOOOOOOO
OOOWWXXXXXXXXXXWWOOOOOOOOOOOOOOOOOOOOOOOOOOWWXXXXXXXXXXWWOOOOOOO
OOOOWWWWXXXXWWWWOOOOOOOOOOOOOOOOOOOOOOOOOOOOWWWWXXXXWWWWOOOOOOOO
OOOOOOOWWWWWWOOOOOOOOOOOOOOOOOOOOOOOOOOOOOOOOOOWWWWWWOOOOOOOOOOO
OOOOOOOOOOOOOOOOOOOOOOOOOOOOOOOOOOOOOOOOOOOOOOOOOOOOOOOOOOOOOOOO
OOOOOOOOOOOOOOOOOOOOOOOOOOOOOOOOOOOOOOOOOOOOOOOOOOOOOOOOOOOOOOOO
