43 43
WWWWWWWWWWWWWWWOOOOOOOOOOOOOOOOOOOOOOOOOOOO
WXXXMMMMMMMXXXWOOOOOOOOOOOOOOOOOOOOOOOOOOOO
WXMRRMMMMMMMSXWOOOOOOOOOOOOOOOOOOOOOOOOOOOO
WXXXMMMMMMMXXXWOOOOOOOOOOOOOOOOOOOOOOOOOOOO
WXMXMMMMMMMXXXWOOOOOOOOOOOOOOOOOOOOOOOOOOOO
WLXMMMMMMMMMMMWOOOOOOOOOOOOOOOOOOOOOOOOOOOO
WXXXXXXXXXMXXXWOOOOOOOOOOOOOOOOOOOOOOOOOOOO
WXXMMMMMXXXXXXWOOOOOOOOOOOOOOOOOOOOOOOOOOOO
WXXXXXXXXXXXXXWOOOOOOOOOOOOOOOOOOOOOOOOOOOO
WXXMXXXXXXXNXXWOOOOOOOOOOOOOOOOOOOOOOOOOOOO
WXXXXMMXXXXXXXWOOOOOOOOOOOOOOOOOOOOOOOOOOOO
WXXMMXXXXXBBBXWOOOOOOOOOOOOOOOOOOOOOOOOOOOO
WXXNXXXXXXXXXXWOOOOOOOOOOOOOOOOOOOOOOOOOOOO
WXXXXXBXXXXXXXWOOOOOOOOOOOOOWWWWWOOOOOOOOOO
WWWWWWWWWWXXXWWOOOOOOOOOOOOOWXNXWOOOOOOOOOO
OOOOOOOOWWXXXWWWWWWWWWWOOOOOWXRXWOOOOOOOOOO
OOOWWWWWWXXMXXXXXMXXXXWOOOOOWXRXWOOOOOOOOOO
OOOWXXXXXXXXXMXXXXXXXXWOOOOOWXMXWOOOOOOOOOO
OOOWXXMMMMMMMMMMMMMMMMWWWWWWWXXXWOOOOOOOOOO
OOOWXXXXXXXXXXXXXXXXXXWWXXXXXXXXWOOOOOOOOOO
OOOWWWWWWXXXMXXXXXLXXXWWXXXXXXXXWOOOOOOOOOO
OOOOOOOOWXRXXXXXXXXXSXWWXXXXXXXXWOOOOOOOOOO
OOOOOOOOWXRXXBMXMXXLXXWWWWWWWXXXWOOOOOOOOOO
OOOOOOOOWMXXXXXXXXXMXXWWWWWWWXXXWWWWWWOOOOO
OOOOOOOOWXBXXBMXXMXXXXWWXXXXXXXXXXXXXWOOOOO
OOOOOOOOWXMXXXXXXMXXXXXXXXXXSXXXXXXNXWOOOOO
OOOOOOOOWXXXXXXXXXXMXLXXXXXXXXXXXXXXXWOOOOO
OOOOOOOOWXLXLXMMMXXXXXXXXXXXXXLXXXXXXWOOOOO
OOOOOOOOWXXXXXXMXXXXXXWWXXXXXXDDXXLXXWOOOOO
OOOOOOOOWWWWWWXMXWWWWWWWXXXXXXNNNXLXXWOOOOO
OOOOOOOOOOOOOWXXXWOOOOOWXXXXXXXXXXLXHEOOOOO
OOOOOOOOOOOOOWXXXWOOOOOWXXXXXXXXXXXXXWOOOOO
OOOOOOOOOOOOOWXXXWWWWWWWXXXXXXXXXXXXXWWWWWW
OOOOOOOOOOOOOWXXXWWXXXXXXXXXXXXXXXXXXXXXXXW
OOOOOOOOOOOOOWWWWWWXNXXXXXXXXMXMXXMXXXXMRXW
OOOOOOOOOOOOOOOOOOWXXXXXXXXXXXXXXXMXXXXXNXW
OOOOOOOOOOOOOOOOOOWWWWWWXXXXXXXXXXXXXWWWWWW
OOOOOOOOOOOOOOOOOOOOOOOWWWWWWXXXWWWWWWOOOOO
OOOOOOOOOOOOOOOOOOOOOOOOOOOOWXNXWOOOOOOOOOO
OOOOOOOOOOOOOOOOOOOOOOOOOOOOWXMXWOOOOOOOOOO
OOOOOOOOOOOOOOOOOOOOOOOOOOOOWXRXWOOOOOOOOOO
OOOOOOOOOOOOOOOOOOOOOOOOOOOOWXXXWOOOOOOOOOO
OOOOOOOOOOOOOOOOOOOOOOOOOOOOWWWWWOOOOOOOOOO
