100 100
WWWWWWWWWWWWWWWWWWWWWWWWWWWWWWWWWWWWWWWWWWWWWWWWWWWWWWWWWWWWWWWWWWWWWWWWWWWWWWWWWWWWWWWWWWWWWWWWWWWW
WWXXWXXXXXXXXWWXXXXWXXXXXXWXWXXWWWXXXXXXWXXXXXXXXXXXXXXXXXXWXXXXWXXXXXXXXXXXXWXXXXWXXWXWXWXXXXXXXWXW
WXXXXXXXXXXXXXXXXWXXXXXXXXXXXXXXWXXXXWXXXWXXXXXXXXWXXXXXWXXXXXXXXXXWXXXWXXXXXXWXXXXXXXXXXXXXXXXXXXXW
WXWXXWXXXXXXWXXXXXXXXXXXXXXXXXXXXXXXXXXXXXXXXXXXXXWXXXXXXXXXXXXXXWXWWXWXXXXXWXXXWXXXXXXXXXXXXWXXXXXW
WXXWXXXXXXXWXXXXXXXWXXXXXXXXXXXXWXXXXXXXXXXXXXXXWXXXXXWWXXXXXXXXXXXXXXXXXXXXWXXXXXXXXXXXXXXWXWXXXXXW
WXXXXXXXXXXXWXXXXXXXXXXXXXXXXXXXXXXXXXXXXXXXXXXXWXXXXXXWXXXXXXXXXWXXXXXXXXXXXXXXXXXXXXXXWXXXXXXXXXXW
WXXXXXXWXXXXXXXXXXXXXXXXXXXXXWXWXXXXWXXXXXXXXXXXXWWXXXXXXXXXXXWXXXXWXXXXXXWXXXXXXXXWXXXXXXXWXXXXWWXW
WXXXXXXXXXXXXXXXXXXXXWXXXXXWXXXXXXXXXXXXXXXXXXXXXXXXXXXXXXXXXXXXXXXWXXXXXXXXXXXXXWWWXXXXXXXXXXXXXXXW
WXXXXXXXXXXXXXXXXXXXXXXXXXXXXXXXXXXXXXXXXXXWXXXXXXXXXXXXWXXWXXXXXXXXWXXXXXXWWXXXWWXXXXXXXWXXXWXXXXXW
WXXXXWXXXXXWWXXXXXXWXXXXXWXXXXXXXXXXXXXXXXXXXXXXXXXXXXWXXXXXXXXXXXXXXXWXXXXXXXXXXXXXXXXWXXXXXXXXXXXW
WXXXXWXXXXXXXXXXXXXXXXXXXWXXXXXXXXXXXXXXXXXXXXXXXWXXXXXWXXXXWXXXXXXXXXXXXXXXXXXXXXXXXXXXXXXWXXWXXXXW
WXXXXXXXXXWXXXXXXXXXXXXXXXXXXXXXXWXXXXXXXXXXXXXXXWXXXXXXWXXXXXXXXXXWXXXXXXXXXWXXXXXWWWXXXXXXXXXXXXXW
WXXXXXXXXWXXXXWXXXXXXXXXXXXXXXWWXXXXWXXWXXWWXWXXXXXXXXWXWXXXXXXXXWXXXXXXXXXXWXWXXXXXXXXXXXXWXXXXXXXW
WXWXXXXXXXXXXXXXXXXXXXXXXXXXXXXXXXXXXXXXXXXXXXXXXXXXXXWXXXXXXWXXXXXXXXXXXXXXXXXXXWXXWXXXWXXXXXXXXXXW
WXWXXWWXXXXXXWWXXXXXWXXXXXWXXXXXXWXXXXXXXXXXXXXXMMMMMMMMMMMMMMMMMMMXWXXXXXWXXWXXXXXXXWXXXXXXXXXXXXXW
WXXXWXXXWXXXXXXXXWXXXXXXXXXXXXXXXXXXXXXXXXXXXXWXXXXXXXXWXXXXXXXXXXWXXWXXXXXXXXXXXXXXXXXXXXXWXXXWXXXW
WXXXXWXXXXXXXXXWXXXXXXXXXXXXXXXXXXXXXXXXXWXXXXXWXXXXWXXXXXWXXWXXXXXXXXWXXXWXXXXXXXXXXXWXXXXXXXXXXXXW
WWXXXXXXXXXWXXWWXXXXWXXXXXWXXXXXXWXXXXXXXWXWXWXXXXXXXWXXXXXXXXXXXWXXXXXXXXXXXXWXXXXXXXXXXXXXXWXXWXXW
WXXXXXXXXXXWWXXXWXXXWXXXXXXXXXXXXXWXXXXXWXXXXXXXXXXXXXXXXXXXXXXXXXXXXXXMXXXWXWXXXXXXXWXXXWXXXXWWXXXW
WXXXWXXWXXXXXXXXXXWXXMXXXXXXXXXXXXWXWXXXXXXXXXXXXXXXXXXXXXXXXXXXXXXXXXXXXXXXXXXXXXXXXXXXXXXXXXXXXXXW
WXXXXXXXXXXXWXXWXXWXXXXXXXXXXXXXXXXXXXXXXXXXXXXWXXXXXXXXXXXXXXXXXXXXXXXXXXXXXXXXXXXXXXXXXXXXXWXXXXXW
WXXXXXXWXXXWXXXXXXXXXXXWXXXXXXXXXXXXXXXXXXWXXXXXXXXXXXXXXXWXXXXXXXXXXXXXXXWXXXXXXXXXXXXXXXXXXXXXWXXW
WXXXXXXXXXXXXXXXWXXXXXWXXXWXXXXXXXXXWXXXWXXWXXXXXXWXXXXXXXXXXXXXXXXXXXXWXWXXXXXXXXWXXXXXXXXXXXXXXXXW
WXXXWXXWWXXXXXXXWWXXXXXXXXXXWXXXXXXXWWXWXXXXXXXXXXXXXXXXXXXXXXXXXXXXXWXXXXXXXXXXWXXXXXXXXXWXXXXXXXXW
WWXXXXXWWXXXXWXXXXXXXXXXXXWXXXXXWXXXXXXXXXXXXXXXXXXXXXWXXXXXXXXWXXXXXWXXXXWXWXWXXXXXWXXXXXXXXXXXXXXW
WXXXWXXWWXXXXXXXXXXXXWXXXXXXXWXXXXWXXWXWXWXXXXXXXXWXXXXXXXWXXXXXWXXXXXXXXXXXXXXXXXXXXXXXXXXXXXXXWXWW
WXXXXWXXXXXXXXXXXWXWXXXWXXXXXWXXXXXXXXXXXXXXXHXXXXWXXXXXXXXXXWXXXXXXWXWXXXXWXXXXXXXXWXXXXXWXXXXXXXXW
WXXXXXXXXXXXXXXXXXXXXXXXXXXXXXXXXXXXXXXXXXXXXXXXXXXXXXXXXXXXXXXXXXWXXWWXXXXXXXXXXXXXXXMXXXXXXXXXXXXW
WXXXXXXXXXXXXXXWXXWXXXXXXXXXXXXXXXXXXXWXXXXXXXXXXXXXXXXXXXXXXXXXXXXXXXXXXXXXXXXXXXXXWXXXXXXXXXXXXXXW
WXXXXXXXXXXXXXXXXXXXXXXXXXXXXXXXXWXXXXWXXXXXXXXXXXXXXXXXXXXXXXXXXXXXXWWXXXWXXWXXWXXXWWXXXWXXXXXXXXXW
WXXWXXXXXXXXXXXXXXXXXXWXXXMXXXXXXXWXXXXXXWXXXWXXXXXWXXXXXXXXXXXXXXXXXXXXXXXXXXXXXXXXXXXXXXXXXXXXXXXW
WXWXXXXXXXXXXXXXXXXXXXXWXXXXXXXXXXXXXXXXXXXXXXXXXXXWXXXXXXXXXXWXXXXXXXXXXXXXXXXXXXXWXXXXXXXXXXXXXXXW
WXXXXWXXXXXXXXXXXXXXXXXXXXXXXXXXXWXWXXXXXXXXWXXXXXXXXXXXXXXXXXXXXXXXXWXWWXWXWXXXXXXXXXWXXXWWXXWXXXXW
WXXXXXXXXXXXXXXXXWXWWXXWXXXXMXWXXXXXXXXWXXXXXXXXXXXXXXMXXXWWXXXXXXXXXXWXXXXXXXXXXXXXXXXXXXXWXXXXXXXW
WXWXXXXXXXXXWXXXWXXXXXXXWXXXXXXXXXWXXXXXWXXXXXWXXXXXXXXXXXXWXXXXWXXXXWXXXXXWXXXXXXXWXXXXWXXXWWXXXXXW
WXXXWXXXXXXXXXXXXWXXXXXXWXXXXXXXXXXXXXWXXXXXXXXWXXXXXXXXWXXXXXWXXWXXWXXXXXXXXXXXXXWXXXXXXXWXXXXXXXXW
WXXXXXXXXXXXXXXXXXXXXXWXXXXXXXWWXWXXXXXWXXXXXXXXXXXXXXXXWXXXXXWXXXXXWXXXXXXXXXXXXXXXXXXXXXXXXXXWXXXW
WXXXXXXXXXXXWXXXXXXXXXXWWXXXXWWXXXXXXXXXWXWXXXXXXXXWWXXXXXXXXXXXXXXWXXXXXXXXXXXXXWXXXXXXXXXXXXWXXWXW
WXXXXXXXXXXXXXXXXXWXWXXXXXXXXXXWXXXXXWXXXXXXXXXXXXXXXXWXXXWXWWXXXXXXXXXXXXXXXXXXXXXXXXXXXXXXXXXXXXWW
WXXXXXXWXWXXXXXXXWWXWXXMXXXXXXXXXXXXXXXXWXXXXXXXXXXXXXXXXXXXXXMXXXWXWXXXXXXXXXXXXXWXXXXWXXWXXXXXXXXW
WXXXXXXXXXXXXXXXWXXXXXXXXWXWXXXXXXXXXWXXXXWXXXXXWXWXXXXXWXXXXXXXXXXWXXXWXXXXXXXXXXXXXXXXXXXXXXXXXXXW
WWXXXXXXXXXXXXXWXXXXXXXXXWXXXXXXXXXWXXXWXWXXXXXXWXXXXWWXXXWXXXXXXXXXXXXXXXXXXXXXWXWXXXXXXXXXXWXXXXWW
WXXXXXXXXXXXXXWXXXXWXXXXXXXXXXXWWXXWXXXXXXXXXWXXXXXXXXXWWXXXWXXXXXXXWXXXXXXXXXXXXXXXXXXXXXXXXXXXXXXW
WXXXXWXXXXXXXXXXXXXXXXXWXXXXXXXXXXXXXXXXXWXWXXXXWXXXWXXXXXWXXXXXXXXXXXXXXXXXXXWXXXXXXXXXXXXXXXXXXWXW
WXXXXXXXXXXWXXWXXXXXXXXXXXXXXWXXXXWXXXWXXXXXXXWXXXXXXXXXXXXXXXXXXXXXXXXXXXXXWXWXXXXXXXXXXXXXXXXXXXXW
WWXXXXXXXXXXXXXXXXXXXWXXXXXXXXXWXXXWXXXXXXXXWXXXXXXXXXXXXXXXXWWXXXXWXXXXXXXXXXXXWXXXXXXXXXXXXXXXXXXW
WXXXXXXXXXXXXXWXXXXXXXXXWXXWXXXXXXXXXXXXXXXXXXXXWXXXXXXXXXXXXXXXXXXXXXXXXXXXXWWXXXXXWXXXXXXXWXXXXXXW
WXXXXXXXXXXXWXXXXXXXXXXXXXXXXXXXXXXXXWXXXXXXXXXXXWXXXXWWXXXWXXXXXXXXXXXXXXXXXXXXXXXXXXXWXXXXXXXXXXXW
WXXXXWXWXXXXXXXXXXXXXWXXXXXXXXXXXXXXXXXWXXXWXXXXXXXXXXXXXXXXXXXWXXXXXXXXXXXXXXXXXXXXXXXXXXXXXXXXXXXW
WXXXWXWXXXXXXXXWXXXXXXXXXXXXXXXXXWXWXXWXXXXXXXXXXXXXXXWXXXXXXXXXWXXXXXXWXXXXXXWWXXXXXXXXXXXXXXXXXXXW
WWXXXXXXXXXXXXXXXXXXXXXXXXXXWXXXXXXXXXXXXXXXXXXXXXXXXXXXXXWXXXXXXXXXWXXWXXXXXXXXXXXXXXWXXXXXXXXWXXWW
WXXXXXXWXXXXXXXXXXXXXXXXXXXXXXXXXXXXXXXXXXXXWWXXXWXWXXXXXXXXXXXWXXXXXXXXXXXXWXXXXXWXXXXXWXXXXXXXXXXW
WXWXXXXXXXXXWXXXXXXXXXXXXXXXXXWXXXXXXXXXXXXXXXXXXXXXXXXXXXWXXXXXXXXXXXXXXXWXXXXXXXWXWXWXXXXWWXXXXXXW
WXXWXXXXXWXXXXXXWXXXXXWXXXXXWXXXWXXXXWXXXXXXXXXXXXWXXXXXXXXXXXXXXXXXXWXXXXXXXXXXXXXXXXXXXXXXXXXXXXXW
WXXXXXXXXXXXXXXXXXWXXXWWXXXXWXXXWXXXXXXXWXXXWXWXXXXXXXXXXXXXXXWXXXXXWXXXXXXXXXXXXXXXWXXXXXXXXXXXXXXW
WXXXXXXXXXXXXWXXXXWXXXXXXXXXXXXXWXXXXXXXXXXXWXXXXXXXXXXWXXXXWXXXWXXXXXXXXWXXXXXXXXXXXXWXXXXXXXXXXXXW
WXXXXXXXXXXXXXXXXXXXXXXXXXXWXXXXXXWXXXXXXXXXXXXXXXXXXWXXXXXWXXXXXXXXXXXXXXXXXXXXXWXXXXXXWXXXXXXWXXXW
WXXXXXWXXXXXXXXXXWXXXXXXXXXXXXXWXXXXXXXXXXXXXXXXWWXXXXXXXXXXXWXXXXXXWXXXXXXXXXXXXXXXXXXXWWWXXXXXXWWW
WXXXXXXXXXXXXXXXXXXXXXXXXXXXXXXXXXXXXXXXXXXXXXXXXXWXXXWXWXXXXXXXXXXXXXXXXXXXXXXXXXXXXXXXXXXWXXXXXXXW
WXXWXXWXXWXXXXXXXXXXXXXXXXXXXXXWXXWWWXXXXXXXXXXXXXXXXXXXXXXXXXXXXXXXWXXXXWWXXXXXXXXXXXXXXXXXXXXXXXXW
WWXXXXXXXXXXXXXXXWXWXXXXXXWXWXXXXXWXXXXXXXXXXXXXXXXXXWXXXXXXXXXWXXXXXXWXXXXXXXWXXXWXXWXXXXXXXXXXXXXW
WXXXXWXXXXXXXXXXXXXXXXXXXXXXWXXXXXXXXXXXXXXXXXXWXXXXXXXXXXXXXXXXXXXXXXXXXXWXXWXXXXXXXXXXXXXXXXXXXXXW
WWXXXXWXXXXXXXXXXXXXXXXXXXXXXXWXXXXXXXXXXXXXXXWXXXXXXXWXXXXXXXXWXWXXXXXXXXWWXXXXXWXXXXXWXXXXXXXXXXXW
WXXXXXXWXXXXXXXXXXXXXXWXXXXXXXWWWXXXXXWXXXXXXXXXXXXXXXXXXXXXXXXXXXXXXXXXXXXXXXXXXXWWXXXXXWXXXXXXXXXW
WXXXXXXXXXXXXXXXXXXXXXXWXXXXXXXXXWXXWXXXWXXXXXXXXWXXXXXXXXWXXXXXXXWWXXXXXXXXXXXXXXXXWXXWXXXXXXXXXXXW
WXXXXWXXXXXXXXXXXXXXXXXXXXXXXXWXXXXXXWXXXXXXXXXXXXXXXXXWXXXXXXXWXXXXXXWXXXWXXWXXXXXXXXXXXXXXXXXXWWXW
WXWXXXXXXXXXXXXXXXXXXXXXXXXXXXXXXXXXXXXXXXXXXXXXWXXXXXXXXXXXWXXXXXXWXXXXXXWXXWXXXXXXXXXXXXWXXXXXXXXW
WXXXXXXWXXXXXXWXXXWXXXXXXXXXXXXXXXXXXXXXXXXXWXXXWXXXXWXXXXWXXXXXXXXXXXXXXXXXXXXWXXXXXWXXWXWXXXXXXXXW
WXXWXXXXXXXXXXWXXXXWXXXXXXXXXXXXXXXXXXXXXXXXXXXXXXXXXXXXXXXXXXXXXXXXXXXXXXWXXXXXXXXXXXXXXXXWXXXXXXXW
WXXXXXXXXXXXWXXXXXXXXXXXXXXWXXXXXXWXWWXXXXXXXXXXXXXWXXXXXXXXXXXXXXXXXXXXXXXXXXXWXXXXXXXXXXXXXXXXXXXW
WXXXWXWXXXXXXXXWXXXXXXWXXXXXXXXWXXXXXXXXXWXXXXXXXXWXXWXXXXXXWXWXWXXXXXXXXXXXXXXXXXXXXXWXXXXXWXXXXXXW
WXWWXXXXXXXXXXXXXXXXXXXXXXXWXXXXXXXXXWXXXXXXXXXXXXXXXXXXXXXXXXXXXXXXXXXXXXXXXXXXXXXXXWXXXXWXXXXWXXXW
WXXWXXXXXXXXXXWXXXXXXXXWXXXWWXXXXXXXXXXXXXXXXXXXXXXXXXXXXWXWXWXXXXXXXXXXXXXWXXXXXWXXXXXXWXXXXWXXXXXW
WXXXWXXWWXXXXWXXXXWXXXXXXXWXXXXXXXXXWXXXXXXXXXXXXXXXWXXXXXXXXXWXXXXXWXXXXXWXXXXXXXXXXXXXXXXXXXXXXXXW
WXXWXXXXXXXXXWXXWWXXXXWXXXXXWXXXXXXXXXXXXXXXXWWWXXXWXXXXXXXXXXXXXXXXXXXXXWXXXXXXWXXXXXXXXXXXXXXXXXXW
WXXXXXXXXXXXWXXXXXXXXXXXXXXXXXXXXXXXXXXXWXWXXXXXWXWXXXXXXXXXWXXXXXXXXXXXXXXXXXXXXXXXXXWWXXXXXXXXXXXW
WXXXXWXXWXXXXXXXXXXXXXXXXXXXXXXXXXXXXXXXXXXWXXXXXXXXWXXXXXXXXXXXXXXXWXXXXXXXXXXXXXXXXXXXXXXXXXXXXXWW
WXXXWXXXXXXXXXWXXXXXXXXXXWXXXXXXXXXXXXWXXXXXXXXXXXXXXXXXXXXXXXXXXXXXXXWXXXXXXXXXXWXXXXXXXXWXXWXXXXXW
WWXXWWXXXXXXWXXXWXXXXXXXXXWXXXXXXXXXXXWXXXXXXXXXXXXXXXXWXXXXXXXXXWXXXXXWXXXXWXWXXWXXXXXXXWXXWXXXXXXW
WXXXWXXXXXXXXXXXXXXXXXXXXXXXXXXWWXXXXXXXXXXXXXXXXXXXXXXWXXXXXXXXXXXXXXXXXXXXXXXXWXXXXXXXXWXXXXXXXXXW
WXXXXXXXXXXXXXXXXXXXXXXXWXXXWXXXXXXWXXXXXWXXXXXXXWXXXXXXWXXXWXXXXXXXXWWXXXXXXXXXXXXXXXXXXWXXXXXXWXXW
WXXXXXWXXXXXXXXXXXXXXXXXXXWXXXXXXXXXXXXXXXXXXXXXXWXXXXXXXWXXXXXXXXXWXXXXXXXXXXXWXXXXXWXXXXXXXXXXXXXW
WWWXXXXXXXXXXWXXXXXXXXXXXXXXXXXXXXXXWXXXWXXXXXXXXXXWXXXXXXXXWXXXXXXXWWXXXXXXXXXWXXXXXXXXXXXXXXXXXXXW
WXWXXXXXXXXXXXXWXXXXXXXXXXXXXXXWXWXXXXXXXXXWXXXXXXXXXXWXXXXXXXXXWXXXXXXXXXXXXXXXXXXXXXXXXXXXXXXXXXXW
WXXXXXXXXWXXXXXXXXXXXXXXXXXXXXWWXXXXWXXXXXXXXXXXXXXXXXXWXXXXXXXXXXXWXXXXXXXXXWWXXWXWXXXXXXXWXXXWXXXW
WXWXWXXXXWXWXXXXXXXXXXXXXXXXXXXXXXXXXWXXXXWXWXXXXXXXXXXWXXXXXXXXXXXWXXXXXXXXXXXXXXXWXXXXXXXXXXXXXXWW
WXXWXXWXXWXXXWXXXWXXXXXWXXXXXXXXXXXXXXXXXXXXXXXXXXXXXXXWXXXXXXXXXXXXXXXXXXXWXXXXWXWXXXXXXXXXXXXWXXXW
WXXXXXXWXXXXXXXXXXXXXXXXXXXXXXXXXXXXXXXXXXWXXXXXXXXXWXXXXXXXXXXXXXXXXXXXXXXXXXXXXXXXXXXXWXXXXXXXXXXW
WXXXXXXXXXXWXXWXXXXWWXXWXXWXXXXXXXXXXXXXXXXXXXXXXXXXXXXXXWXXXXWXXXXXXXXWXWXXXXXXXWXXXXXXXXXXXXXXXXXW
WXXXXXXXXXXXXXXXXXXXXXXXXXXXWXXXXXXXXXXXXXXXXWXXXXXXXXXXXXXXXXXXXXXXXWXXXXXXXXXWXXXXXXXXXXXXXXXXXXXW
WXWXXXXXXXXXXWXXXWXXXXXWXXXXXXXXXXXXXXXXXXXXXXXXXXXWXWXXXXXXXXXXXXXXXXXXXXXXXXXXWXXXXXXXWXXXXXXXXXXW
WXXXXXXXWXXXXXXXXXXXXXXXXXXXXXXXXXXXXXXXXXXXXXXXXXXXXXXXXXXWXXWXXXXXXXWXXXWXXXXXXXXXXXXXWXXXXWXXXXXW
WXXXWXWXXXXWWXXXXXXXXXXXXXXWWXXXXXXXXXXWXXXXXXXXXXXXXXXWXXXXWWXWXXXXXXXXXXWXXXWXXXXXWXXWXXWXXXXXXXXW
WXXXXXXXXXXXXXXXXXXWXXXXXXXXXXXXWXXXXXXXXXXXXXXXWXXXXXXXXXXXXXXXXXXXXXXXXXXXXXXXWWXXXXWXXXXXXXXXXXXW
WXXXXXXXXXWXXXXXXXXXXXXXWXXXXXXXXXXXXXWXXXXXXXXXWXWXXXXXWXXXXXXXXXXXXXWXXWXXXXXXXXXWXXXXXXXXWWXXXXXW
WXXXXWXXXXXXXXXXXXXXXXXXXWWWXWXXXXXXWXXXXXXXWXWXXXXXXXXXXWXXXXXWXXXXXXXXXXXXXXXXXXXXWXXXXXXXXXXXXXXW
WXXXXXXXWXXXXXXXXXXXXXXXXXXXXXXXXXXXXXXXXXXXXXXXXXXXXXWXXXXXWXXXXXXXXXXXXWXXXXXXXXXXXWWXXXXXXXXXXXXW
WXXXXXXXXXXXXWXXXXXXXXXXXXXXWXWXXXXXXXXXXXXXXXXXXXXXXXXWXXXXWXXXXXXXXXXXXXXXXXXWXXXXXXXXXXXXXXWXXXXW
WXXWXXWXXWXXXXXXXXXXXXXXXXXXXXXXXXXXXXWXWXXXXWWXXXXXWXXXWXXXXWXXXXXXXXXXXXXXXXXXXXWXXXXXXXXXXXXXXXXW
WWWWWWWWWWWWWWWWWWWWWWWWWWWWWWWWWWWWWWWWWWWWWWWWWWWWWWWWWWWWWWWWWWWWWWWWWWWWWWWWWWWWWWWWWWWWWWWWWWWW
