15 34
OOWWWWWEWWWWWOO
OOWXXXXHXXXXWOO
OOWXXXXXXXXXWOO
OOWXXXXXXXXXWOO
OOWXXXXXXXXXWOO
OOWXXXXXXXXXWOO
OOWXXXXXXXXXWOO
OOWXXXXXXXXXWOO
OOWWWWXXXWWWWOO
OOOOOWXXXWOOOOO
OOOOOWXXXWOOOOO
OOWWWWXXXWWWWOO
OOWXXXXXXXXXWOO
OOWXXXXXXXXXWOO
OOWXXMXXXMXXWOO
OOWXXXXXXXXXWOO
OOWXXXXMXXXXWOO
OOWXXXXXXXXXWOO
OOWXXXXXXXXXWOO
OOWWWWXXXWWWWOO
OOOOOWXXXWOOOOO
OOOOOWXLXWOOOOO
OOOOOWXXXWOOOOO
OOWWWWXXXWWWWOO
OOWXXXXXXXXXWOO
OOWXMXXXXXMXWOO
OOWXXXXXXXXXWOO
OOWXXMXXXMXXWOO
OOWXXXXXXXXXWOO
OOWXXXXMXXXXWOO
OOWXXXXDDXXXWOO
OOWXLXXXXXXXWOO
OOWXXXXXXXXXWOO
OOWWWWWWWWWWWOO