36 34
OOOOOOOOOOOOOOOOOOOOOOOOOOOOOOOOOOOO
OOOOOOOOOOOOOOOWWWEWWWWOOOOOOOOOOOOO
OOOOOOOOOOOOOOOWXXHXXXWOOOOOOOOOOOOO
OOOOOOOOOOOOOOOWXXXXXXWOOOOOOOOOOOOO
OOOOOOOOOOOOOOOWXXXXXXWOOOOOOOOOOOOO
OOOOOOOOOOOOOOOWWWXXWWWOOOOOOOOOOOOO
OOOOOOOOOOOOOOOOOWXXWOOOOOOOOOOOOOOO
OOOOOOOOOOOOOOOOOWXXWOOOOOOOOOOOOOOO
OOOOOOOOOOWWWWWWWWXXWWWWWWWWOOOOOOOO
OWWWWWWOOOWXXXXXXXXXXXXXXXXWOOOOOOOO
OWXXXXWOOOWXXXXXXXXXXXXXXXXWOOOOOOOO
OWXXXXWOOOWXMXXMXXXXXXMXXMXWOOOOOOOO
OWXXXXWWWWWXXXXXXXMXMXXXXXXWOOOOOOOO
OWXXLXXXXXXXXXXXXXXXXXXXXXXWOOOOOOOO
OWXNXXMXXXXXXXXXXXXXXXXXXMXWOOOOOOOO
OWXXLXXXXXXXXXXXXXXXXXXXXXXWOOOOOOOO
OWXXXXWWWWWXXXXXXXXXXXXXXRXWOOOOOOOO
OWXXXXWOOOWXXXXXXXXXXXXXXXXWOOOOOOOO
OWXXXXWOOOWXXRXXXXXXXXXXXXXWOOOOOOOO
OWWWWWWOOOWXXXXXXXXXXRXXXXXWOOOOOOOO
OOOOOOOOOOWXXXXXXXXXXXXXXXXWOOOOOOOO
OOOOOOOOOOWWWWWXXWWWWWWWWWWWOOOOOOOO
OOOOOOOOOOOOOOWXXWOOOOOOOOOOOOOOOOOO
OOOOOOOOOOOOOOWXXWOOOOOOOOOOOOOOOOOO
OOOOOOOOOOOOOOWXXWOOOOOOOOOOOOOOOOOO
OOOOOOOOOOOOWWWXXWWWOOOOOOOWWWWWWWOO
OOOOOOOOOOOOWXXXXXXWOOOOOOOWXXXXXWOO
OOOOOOOOOOOOWXXXXXXWWWWWWWWWXXXXXWOO
OOOOOOOOOOOOWXBXXBXXXXXXXXXXXMDDXWOO
OOOOOOOOOOOOWXXXXXXXXXXXXXXXXXXXXWOO
OOOOOOOOOOOOWXXXXXXWWWWWWWWWXXXXXWOO
OOOOOOOOOOOOWXXXXXXWOOOOOOOWWWWWWWOO
OOOOOOOOOOOOWWWWWWWWOOOOOOOOOOOOOOOO
OOOOOOOOOOOOOOOOOOOOOOOOOOOOOOOOOOOO
