43 43
W W W W W W W W W W W W W W W O O O O O O O O O O O O O O O O O O O O O O O O O O O O 
W X X X M X X X X X X X X X W O O O O O O O O O O O O O O O O O O O O O O O O O O O O 
W X M X X X X X X X X M X X W O O O O O O O O O O O O O O O O O O O O O O O O O O O O 
W X X X M X X X X X X X X X W O O O O O O O O O O O O O O O O O O O O O O O O O O O O 
W X M X X X X X X X X X X X W O O O O O O O O O O O O O O O O O O O O O O O O O O O O 
W X X X X X X X M X X X X X W O O O O O O O O O O O O O O O O O O O O O O O O O O O O 
W X X X X X X X X X X X X X W O O O O O O O O O O O O O O O O O O O O O O O O O O O O 
W X X X X X X X X X X X X X W O O O O O O O O O O O O O O O O O O O O O O O O O O O O 
W X X X X X X X X X X X X X W O O O O O O O O O O O O O O O O O O O O O O O O O O O O 
W X X M X X X X X X X X X X W O O O O O O O O O O O O O O O O O O O O O O O O O O O O 
W X X X X M M X X X X X X X W O O O O O O O O O O O O O O O O O O O O O O O O O O O O 
W X X M M X X X X X X X X X W O O O O O O O O O O O O O O O O O O O O O O O O O O O O 
W X X X X X X X X X X X X X W O O O O O O O O O O O O O O O O O O O O O O O O O O O O 
W X X X X X B X X X X X X X W O O O O O O O O O O O O O W W W W W O O O O O O O O O O 
W W W W W W W W W W X X X W W O O O O O O O O O O O O O W X X X W O O O O O O O O O O 
O O O O O O O O W W X X X W W W W W W W W W W O O O O O W X X X W O O O O O O O O O O 
O O O W W W W W W X X M X X X X X M X X X X W O O O O O W X X X W O O O O O O O O O O 
O O O W X X X X X X X X X M X X X X X X X X W O O O O O W X X X W O O O O O O O O O O 
O O O W X X X X X X X X X X X X X X X X X X W W W W W W W X X X W O O O O O O O O O O 
O O O W X X X X X X X X X X X X X X X X X X W W X X X X X X X X W O O O O O O O O O O 
O O O W W W W W W X X X M X X X X X X X X X W W X X X X X X X X W O O O O O O O O O O 
O O O O O O O O W X X X X X X X X X X X X X W W X X X X X X X X W O O O O O O O O O O 
O O O O O O O O W X X X X B M X M X X X X X W W W W W W W X X X W O O O O O O O O O O 
O O O O O O O O W M X X X X X X X X X M X X W W W W W W W X X X W W W W W W O O O O O 
O O O O O O O O W X B X X B M X X M X X X X W W X X X X X X X X X X X X X W O O O O O 
O O O O O O O O W X M X X X X X X M X X X X X X X X X X X X X X X X X X X W O O O O O 
O O O O O O O O W X X X X X X X X X X M X X X X X X X X X X X X X X X X X W O O O O O 
O O O O O O O O W X X X X X X X X X X X X X X X X X X X X X X X X X X X X W O O O O O 
O O O O O O O O W X X X X X X X X X X X X X W W X X X X X X D D X X X X X W O O O O O 
O O O O O O O O W W W W W W X X X W W W W W W W X X X X X X X X X X X X X W O O O O O 
O O O O O O O O O O O O O W X X X W O O O O O W X X X X X X H X X X X X X W O O O O O 
O O O O O O O O O O O O O W X X X W O O O O O W X X X X X X X X X X X X X W O O O O O 
O O O O O O O O O O O O O W X X X W W W W W W W X X X X X X X X X X X X X W W W W W W 
O O O O O O O O O O O O O W X X X W W X X X X X X X X X X X X X X X X X X X X X X X W 
O O O O O O O O O O O O O W W W W W W X X X X X X X X X X M X M X X X X X X X X X X W 
O O O O O O O O O O O O O O O O O O W X X X X X X X X X X X X X X X X X X X X X X X W 
O O O O O O O O O O O O O O O O O O W W W W W W X X X X X X X X X X X X X W W W W W W 
O O O O O O O O O O O O O O O O O O O O O O O W W W W W W X X X W W W W W W O O O O O 
O O O O O O O O O O O O O O O O O O O O O O O O O O O O W X X X W O O O O O O O O O O 
O O O O O O O O O O O O O O O O O O O O O O O O O O O O W X X X W O O O O O O O O O O 
O O O O O O O O O O O O O O O O O O O O O O O O O O O O W X X X W O O O O O O O O O O 
O O O O O O O O O O O O O O O O O O O O O O O O O O O O W X X X W O O O O O O O O O O 
O O O O O O O O O O O O O O O O O O O O O O O O O O O O W W W W W O O O O O O O O O O 
