21 21
WWWWWWWWWWWWWWWWWWWWW
WXXXXXXXXXXXXXXXXXXXW
WXXXXXXXXXXXXXXXXXXXW
WXXWWWWWWXXXWWWWWWXXW
WXXWSSSXXXXXXXXXXWXXW
WXXWSSSNLXXXXXXXXWXXW
WXXWXXXXXXWRRRRRRWXXW
WXXWXXXHXXWXXDDXXWXXW
WXXXXXXXXXWXXXXXXWXXW
WXXXXXXXXWWWXXXXXXXXW
WXXXXXWWWWWWWWWXXXXXW
WXXXXXXXXWWWXXXXXXXXW
WXXWXXXXXXWXXXXXXWXXW
WXXWXXXXXXWXXXXXXWXXW
WXXWXXXXXXWXXXXXXWXXW
WXXWXXXXXXXXXXXXXWXXW
WXXWXXXXXXXXXXXXXWXXW
WXXWWWWWWXXXWWWWWWXXW
WXXXXXXXXXXXXXXXXXXXW
WXXXXXXXXXXXXXXXXXXXW
WWWWWWWWWWWWWWWWWWWWW
