8 7
W W W W W W W W
W H X X X X X W
W X X X X X X W
W X X D D X X W
W X X X X X X W
W X X X X X X W
W W W W W W W W
