data/musics/bgmusic.ogg
36 50
WWWWEWWWWWOOOOOOWWWWWWWWWWWOOOOOOOOO
WXXXHXXXXWOOOOOOWXXXXXXXXXWOOOWWWWWO
WXXXXXXXXWOOOOOOWXXXXSXXXXWOOOWXXXWO
WXXXXXXXXWOOOOOOWXRXXXXXRXWOOOWXLXWO
WXXXXXXXXWOOOOOOWXXXXMXXXXWWWWWXBXWO
WXMXXXXMXWOOOOOOWXMXXXXXXXXXXXXXXXWO
WXXXXXXXXWWWWWWWWXXXXXXXXXXXXXXXNXWO
WXXXXXXXXXXXXXXXXXXXMXXMXXWWWWWXXXWO
WXXXXRXXXXXXXXXXXXXXXXXXXXWOOOWWWWWO
WXXXXXXXXWWWWWWWWXXXXXXXXXWOOOOOOOOO
WXXXXXXXXWOOOOOOWMXXXRXXXXWOOOOOOOOO
WWWWWWWWWWOOOOOOWXXXXXXXXXWOOOOOOOOO
OOOOOOOOOOOOOOOOWXXWWWWWWWWOOOOOOOOO
OOOOOOOOOOOOOOOOWXXWOOOOOOOOOOOOOOOO
OOOOOOOOOOOOOOOOWXXWOOOOOOOOOOOOOOOO
OOOOOOOOOOOOOOOOWXXWOOOOOOOOOOOOOOOO
OWWWWWWWWWWWWWWWWXXWOOOOOOOOOOOOOOOO
OWXXXXXXXXXXXXXXXXXWOOOOOOOOOOOOOOOO
OWXXXXXXRXXXXMXXXXXWOOOOOOOOOOOOOOOO
OWXLXXXXXXXXXXXBXXXWOOOOOOOOOOOOOOOO
OWXLXXXXXXMXXXXXXXXWOOOOOOOOOOOOOOOO
OWXXXXXRXXXXXRXXXXXWOOOOOOOOOOOOOOOO
OWXXXXXXXXXXXXXXXMXWOOOOOOOOOOOOOOOO
OWXXXXXXXXXXXMXXXXXWOOOOOOOOOOOOOOOO
OWXXXMXXBXBXXXXXXXXWOOWWWWWWWWWWWWWW
OWXXXXXXXXXXXXXXXXXWOOWXXXXXXXXXXXXW
OWXSXXXXXXXXXRXNNXXWOOWXLXXXXRXXXNXW
OWXXXXXXXXXXXXXXXXXWOOWXLXXXXXXDDNXW
OWWWWWWWXXWWWWWWWWWWOOWXXXXXXXXXXXXW
OOOOOOOWXXWOOOOOOOOOOOWXXXXXXXXXXXXW
OOOOOOOWXXWOOOOOOOOOOOWXXXXXXXXXXXXW
OOOOOOOWXXWOOOOOOOOOOOWXXMMXXXXMMXXW
OOOOOOOWXXWOOOOOOOOOOOWXXXXXXXXXXXXW
OOOOOOOWXXWOOOOOOOOOOOWWWWWWXXWWWWWW
OOOOOOOWXXWOOOOOOOOOOOOOOOOWXXWOOOOO
OOOOOOOWXXWOOOOOOOOOOOOOOOOWXXWOOOOO
OOOOOOOWXXWOOOOOOOOOOOOOOOOWXXWOOOOO
OOOOOOOWXXWOOOOOOOOOOOOOOOOWXXWOOOOO
OOOOOOOWXXWOOOOOOOOOOOOOOOOWXXWOOOOO
OWWWWWWWXXWOOOOOOOOOOOOOOOOWXXWOOOOO
OWXXXXXXXXWOOOOOOOOOOOOOOOOWXBWOOOOO
OWXXMXXXXXWOOOOOOOOOOOOOOOOWMXWOOOOO
OWXXXXBXXXWOOOOOOOOOOOOOOOOWXMWOOOOO
OWXMXXXXMXWOOOOOOOOOOOOOOOOWMXWOOOOO
OWXXXMXXXXWOOOOOOOOOOOOOOOOWXXWOOOOO
OWXXXSBXXXWWWWWWWWWWWWWWWWWWXXWOOOOO
OWXBXXXMXXXXXXMXXRXXMXXRXXXXXXWOOOOO
OWXXXXXXXXXXXXXXXXXXXXXXXXXXXXWOOOOO
OWWWWWWWWWWWWWWWWWWWWWWWWWWWWWWOOOOO
OOOOOOOOOOOOOOOOOOOOOOOOOOOOOOOOOOOO
