data/musics/bgmusic.ogg
36 34
WWWWEWWWWOOOOOOOOOOOOOOOOOOOOOOOOOOO
WXXXHXXXWWWWWWWOOOOOOOOOOOOOOOOOOOOO
WXXXXXXXXXXXXXWOOOOOOOOOOOOOOOOOOOOO
WXXXXXXXXXXXXXWOOOOOOOOOOOOOOOOOOOOO
WXXXXXXXXXXXXXWOOOOOOOOOOOOOOOOOOOOO
WXXXXXXXWWWWXXWWWWWWWWWWOOOOOOOOOOOO
WWWWWWWWWOOWXXWXXXXXXXSWOOOOOOOOOOOO
OOOOOOOOOOOWSSWXXLNXXWWWOOOOOOOOOOOO
WWWWWWWWWOOWXXWXRXXRXWOOOOOOOOOOOOOO
WXXXXXXXWWWWXXWXXXXXXWOOOOOOOOOOOOOO
WRXXXXXXXXXXXXWXXXXXXWOOOOOOOOOOOOOO
WXXXXXXXXXXXXXWXBXXBXWOOOOOOOOOOOOOO
WWWWWXXXWWWWWWWXXXXXXWOOOOOOOOOOOOOO
WXXXXXXXWOOOOOWXXXXXXWOOOOOOOOOOOOOO
WRXXXXXXWOOOOOWXXXXXXWOOOOOOOOOOOOOO
WXXXXXXXWOOOOOWXXXXXXWOOOOOOOOOOOOOO
WWWWWXXXWWWWWWWXXXXXXWWWWWWWWWOOOOOO
WXXXXXXXXXXXXXXXXXXXXXXXXXXXXWOOOOOO
WRXXXXXXXXXXXXXXXXXXXXXXXXXXXWOOOOOO
WXXXXXXXWWWWWWWXXXXXXWWWWWWXXWOOOOOO
WWWWWWWWWOOOOOWWWWWWWWOOOOWXXWOOOOOO
OOOOOOOOOOOOOOOOOOOOOOOOOOWXXWOOOOOO
OOOOOOOOOOOOOOOOOOOOOWWWWWWXXWWOOOOO
OOOOOOOOOOOOOOOOOOOOOWMXXXXXXMWOOOOO
OOOOOOOOOOOOOOOOOOOOOWXXXXXXXXWOOOOO
OOOOOOOOOOOOOOOOOOOOOWXXXLNXXXWOOOOO
OOOOOOOOOOOOOOOOOOOOOWXXXXXXXXWOOOOO
OOOOOOOOOOOOOOOOOOOOOWXXXDDXXXWOOOOO
OOOOOOOOOOOOOOOOOOOOOWMXXXXXXMWOOOOO
OOOOOOOOOOOOOOOOOOOOOWWWWWWWWWWOOOOO
OOOOOOOOOOOOOOOOOOOOOOOOOOOOOOOOOOOO
OOOOOOOOOOOOOOOOOOOOOOOOOOOOOOOOOOOO
OOOOOOOOOOOOOOOOOOOOOOOOOOOOOOOOOOOO
OOOOOOOOOOOOOOOOOOOOOOOOOOOOOOOOOOOO
