43 43
W W W W W W W W W W W W W W W O O O O O O O O O O O O O O O O O O O O O O O O O O O O 
W X X X M M M M M M M X X X W O O O O O O O O O O O O O O O O O O O O O O O O O O O O 
W X M R R M M M M M M M S X W O O O O O O O O O O O O O O O O O O O O O O O O O O O O 
W X X X M M M M M M M X X X W O O O O O O O O O O O O O O O O O O O O O O O O O O O O 
W X M X M M M M M M M X X X W O O O O O O O O O O O O O O O O O O O O O O O O O O O O 
W L X M M M M M M M M M M M W O O O O O O O O O O O O O O O O O O O O O O O O O O O O 
W X X X X X X X X X M X X X W O O O O O O O O O O O O O O O O O O O O O O O O O O O O 
W X X M M M M M X X X X X X W O O O O O O O O O O O O O O O O O O O O O O O O O O O O 
W X X X X X X X X X X X X X W O O O O O O O O O O O O O O O O O O O O O O O O O O O O 
W X X M X X X X X X X N X X W O O O O O O O O O O O O O O O O O O O O O O O O O O O O 
W X X X X M M X X X X X X X W O O O O O O O O O O O O O O O O O O O O O O O O O O O O 
W X X M M X X X X X B B B X W O O O O O O O O O O O O O O O O O O O O O O O O O O O O 
W X X N X X X X X X X X X X W O O O O O O O O O O O O O O O O O O O O O O O O O O O O 
W X X X X X B X X X X X X X W O O O O O O O O O O O O O W W W W W O O O O O O O O O O 
W W W W W W W W W W X X X W W O O O O O O O O O O O O O W X N X W O O O O O O O O O O 
O O O O O O O O W W X X X W W W W W W W W W W O O O O O W X R X W O O O O O O O O O O 
O O O W W W W W W X X M X X X X X M X X X X W O O O O O W X R X W O O O O O O O O O O 
O O O W X X X X X X X X X M X X X X X X X X W O O O O O W X M X W O O O O O O O O O O 
O O O W X X M M M M M M M M M M M M M M M M W W W W W W W X X X W O O O O O O O O O O 
O O O W X X X X X X X X X X X X X X X X X X W W X X X X X X X X W O O O O O O O O O O 
O O O W W W W W W X X X M X X X X X L X X X W W X X X X X X X X W O O O O O O O O O O 
O O O O O O O O W X R X X X X X X X X X S X W W X X X X X X X X W O O O O O O O O O O 
O O O O O O O O W X R X X B M X M X X L X X W W W W W W W X X X W O O O O O O O O O O 
O O O O O O O O W M X X X X X X X X X M X X W W W W W W W X X X W W W W W W O O O O O 
O O O O O O O O W X B X X B M X X M X X X X W W X X X X X X X X X X X X X W O O O O O 
O O O O O O O O W X M X X X X X X M X X X X X X X X X X S X X X X X X N X W O O O O O 
O O O O O O O O W X X X X X X X X X X M X L X X X X X X X X X X X X X X X W O O O O O 
O O O O O O O O W X L X L X M M M X X X X X X X X X X X X X L X X X X X X W O O O O O 
O O O O O O O O W X X X X X X M X X X X X X W W X X X X X X D D X X L X X W O O O O O 
O O O O O O O O W W W W W W X M X W W W W W W W X X X X X X N N N X L X X W O O O O O 
O O O O O O O O O O O O O W X X X W O O O O O W X X X X X X H X X X L X X W O O O O O 
O O O O O O O O O O O O O W X X X W O O O O O W X X X X X X X X X X X X X W O O O O O 
O O O O O O O O O O O O O W X X X W W W W W W W X X X X X X X X X X X X X W W W W W W 
O O O O O O O O O O O O O W X X X W W X X X X X X X X X X X X X X X X X X X X X X X W 
O O O O O O O O O O O O O W W W W W W X N X X X X X X X X M X M X X M X X X X M R X W 
O O O O O O O O O O O O O O O O O O W X X X X X X X X X X X X X X X M X X X X X N X W 
O O O O O O O O O O O O O O O O O O W W W W W W X X X X X X X X X X X X X W W W W W W 
O O O O O O O O O O O O O O O O O O O O O O O W W W W W W X X X W W W W W W O O O O O 
O O O O O O O O O O O O O O O O O O O O O O O O O O O O W X N X W O O O O O O O O O O 
O O O O O O O O O O O O O O O O O O O O O O O O O O O O W X M X W O O O O O O O O O O 
O O O O O O O O O O O O O O O O O O O O O O O O O O O O W X R X W O O O O O O O O O O 
O O O O O O O O O O O O O O O O O O O O O O O O O O O O W X X X W O O O O O O O O O O 
O O O O O O O O O O O O O O O O O O O O O O O O O O O O W W W W W O O O O O O O O O O 
