40 60
O O O O O O O O O O O O O O O O O O O O O O O O O O O O O O O O O O O O O O O O
O O O O O O O W W W W W W W W W W W W W W W W W W W W W W W W W O O O O O O O O
O O O O O O O W X X X X X X X X X X X X X X X X X X X X X X X W O O O O O O O O
O O O O O O O W X X X X X X X X X X X D D X X X X X X X X X X W O O O O O O O O
O O O O O O O W X X W W W X X X X X X X X X X X X X W W W X X W O O O O O O O O
O O O O O O O W X X X X W X X X X X X X X X X X X X W X X X X W O O O O O O O O
O O O O O O O W X X L X W X X X X X X X X X X X X X W X L X X W O O O O O O O O
O O O O O O O W X X X X W X X X X L X P X L X X X X W X X X X W O O O O O O O O
O O O O O O O W X X W W W X X X X N X X X N X X X X W W W X X W O O O O O O O O
O O O O O O O W X X X X X X X X X X X X X X X X X X X X X X X W O O O O O O O O
O O O O O O O W X X X X X X X X X X X X X X X X X X X X X X X W O O O O O O O O
O O O O O O O W X X X X X X X X X X X X X X X X X X X X X X X W O O O O O O O O
O O O O O O O W X X W W W X X X X X X X X X X X X X W W W X X W O O O O O O O O
O O O O O O O W X X X X W X X X X X X X X X X X X X W X X X X W O O O O O O O O
O O O O O O O W X X N X W X X X X X X X X X X X X X W X N X X W O O O O O O O O
O O O O O O O W X X X X W X X X X X X X X X X X X X W X X X X W O O O O O O O O
O O O O O O O W X X W W W X X X X X X X X X X X X X W W W X X W O O O O O O O O
O O O O O O O W X X X X X X X X X X X X X X X X X X X X X X X W O O O O O O O O
O O O O O O O W X X X X X X X X X X X X X X X X X X X X X X X W O O O O O O O O
O O O O O O O W X X W W W X X X X X X X X X X X X X W W W X X W O O O O O O O O
O O O O O O O W X X X X W X X X X X X X X X X X X X W X X X X W O O O O O O O O
O O O O O O O W X X L X W X X X X X X X X X X X X X W X L X X W O O O O O O O O
O O O O O O O W X X X X W X X X X X X X X X X X X X W X X X X W O O O O O O O O
O O O O O O O W X X W W W X X X X X X X X X X X X X W W W X X W O O O O O O O O
O O O O O O O W X X X X X X X X X X X X X X X X X X X X X X X W O O O O O O O O
O O O O O O O W X X X X X X X X X X X X X X X X X X X X X X X W O O O O O O O O
O O O O O O O W W W W W W W W W W W X X X X X W W W W W W W W W O O O O O O O O
O O O O O O O O O O O O O O O O O W X X X X X W O O O O O O O O O O O O O O O O
O O O O O O O O O O O O O O O O O W X X X X X W O O O O O O O O O O O O O O O O
O O O O O O O O O O O O O O O O O W X X X X X W O O O O O O O O O O O O O O O O
O O O O O O O O O O O O O O O O O W X X X X X W O O O O O O O O O O O O O O O O
O O O O O O O O O O O O O O O O O W X X X X X W O O O O O O O O O O O O O O O O
O O O O O O O O O O O O O O O O O W X X X X X W O O O O O O O O O O O O O O O O
O O O O O O O O O O O O O O O O O W X X X X X W O O O O O O O O O O O O O O O O
O O O O O O O O O O O O O O O O O W X X X X X W O O O O O O O O O O O O O O O O
O O O O O O O O O O O O O O O O O W X X X X X W O O O O O O O O O O O O O O O O
O O O O O O O O O O O O O O O O O W X X X X X W O O O O O O O O O O O O O O O O
O O O O O O O O O O O O O O O O O W X X X X X W O O O O O O O O O O O O O O O O
O O O O O O O O O O O O O O O O O W X X X X X W O O O O O O O O O O O O O O O O
O O O O O O O O O O O O O O O O O W X X X X X W O O O O O O O O O O O O O O O O 
O O O O O O O O O O O O O O O O O W X X X X X W O O O O O O O O O O O O O O O O 
O O O O O O O O O O O O O O O O O W X X X X X W O O O O O O O O O O O O O O O O 
O O O O O O O O O O O O O O O O O W X X X X X W O O O O O O O O O O O O O O O O 
O O O O O O O O O O O O O O O O O W X X X X X W O O O O O O O O O O O O O O O O 
O O O O O O O O O O O O O O O O O W X X X X X W O O O O O O O O O O O O O O O O 
O O O O O O O O O O O O O O O O O W X X X X X W O O O O O O O O O O O O O O O O 
O O O O O O O O O O O O O O O O O W X X X X X W O O O O O O O O O O O O O O O O 
O O O O O O O O O O O O O O O O O W X X X X X W O O O O O O O O O O O O O O O O 
O O O O O O O O O O O O O O O O O W X X X X X W O O O O O O O O O O O O O O O O 
O O O O O O O O O O O O O O O O O W X X X X X W O O O O O O O O O O O O O O O O 
O O O O O O O O O O O O O O O W W W X X X X X W W W O O O O O O O O O O O O O O 
O O O O O O O O O O O O O O O W L X X X X X X X N W O O O O O O O O O O O O O O 
O O O O O O O O O O O O O O O W L X X X X X X X N W O O O O O O O O O O O O O O 
O O O O O O O O O O O O O O O W L X X X H X X X N W O O O O O O O O O O O O O O 
O O O O O O O O O O O O O O O W W W X X X X X W W W O O O O O O O O O O O O O O 
O O O O O O O O O O O O O O O O O W X X S X X W O O O O O O O O O O O O O O O O 
O O O O O O O O O O O O O O O O O W W W W W W W O O O O O O O O O O O O O O O O 
O O O O O O O O O O O O O O O O O O O O O O O O O O O O O O O O O O O O O O O O 
O O O O O O O O O O O O O O O O O O O O O O O O O O O O O O O O O O O O O O O O 
O O O O O O O O O O O O O O O O O O O O O O O O O O O O O O O O O O O O O O O O 