40 40
O O O O O O O O O O O O O O O O O O O O O O O O O O O O O O O O O O O O O O O O
O O O O O O O O W W W W W W W W W W W W W W W W W W W W W W W W O O O O O O O O
O O O O O O O O W X X X X X X X X X X X X X X X X X X X X X X W O O O O O O O O
O O O O O O O O W X X X X X X X X X X D D X X X X X X X X X X W O O O O O O O O
O O O O O O O O W X X W W R X X X X R X X R X X X X R W W X X W O O O O O O O O
O O O O O O O O W X X L W M X X X W W W W W W X X X M W L X X W O O O O O O O O
O O O O O O O O W X X L W M X X X W S X X S W X X X M W L X X W O O O O O O O O
O O O O O O O O W X X W W M X X X W N P X N W X X X M W W X X W O O O O O O O O
O O O O O O O O W X X X X X X X X W L X X L W X X X X X X X X W O O O O O O O O
O O O O O O O O W X X X X X X X X R X X X X R X X X X X X X X W O O O O O O O O
O O O O O O O O W X X X X X X X X M X X X X M X X X X X X X X W O O O O O O O O
O O O O O O O O W X X X X X X X X X X X X X X X X X X X X X X W O O O O O O O O
O O O O O O O O W X X W W R X X X X X X X X X X X X R W W X X W O O O O O O O O
O O O O O O O O W X X N W M X X X X X X X X X X X X M W N X X W O O O O O O O O
O O O O O O O O W X X N W M X X X X X X X X X X X X M W N X X W O O O O O O O O
O O O O O O O O W X X W W M X X X X X X X X X X X X M W W X X W O O O O O O O O
O O O O O O O O W X X X X X X X X X X X X X X X X X X X X X X W O O O O O O O O
O O O O O O O O W X X X X X X X X X X X X X X X X X X X X X X W O O O O O O O O
O O O O O O O O W X X X X X X X X X X X X X X X X X X X X X X W O O O O O O O O
O O O O O O O O W X X X X X X X X X X X X X X X X X X X X X X W O O O O O O O O
O O O O O O O O W X X W W R X X X X X X X X X X X X R W W X X W O O O O O O O O
O O O O O O O O W X X L W M X X X X X X X X X X X X M W L X X W O O O O O O O O
O O O O O O O O W X X L W M X X X X X X X X X X X X M W L X X W O O O O O O O O
O O O O O O O O W X X W W M X X X X X X X X X X X X M W W X X W O O O O O O O O
O O O O O O O O W X X X X X X X X X X X X X X X X X X X X X X W O O O O O O O O
O O O O O O O O W X X X X X X X R X X X X X X R X X X X X X X W O O O O O O O O
O O O O O O O O W W W W W W W W W W X X X X W W W W W W W W W W O O O O O O O O
O O O O O O O O O O O O O O O O O W X X X X W O O O O O O O O O O O O O O O O O
O O O O O O O O O O O O O O O W W W X M M X W W W O O O O O O O O O O O O O O O
O O O O O O O O O O O O O O O W X X X X X X X X W O O O O O O O O O O O O O O O
O O O O O O O O O O O O O O O W X X X X X X X X W O O O O O O O O O O O O O O O
O O O O O O O O O O O O O O O W X X W W W W X X W O O O O O O O O O O O O O O O
O O O O O O O O O O O O O O O W X X W W W W X X W O O O O O O O O O O O O O O O
O O O O O O O O O O O O O O O W X X N L L N X X W O O O O O O O O O O O O O O O
O O O O O O O O O O O O O O O W X X X H X X X X W O O O O O O O O O O O O O O O
O O O O O O O O O O O O O O O W X X X S S X X X W O O O O O O O O O O O O O O O
O O O O O O O O O O O O O O O W W W W W W W W W W O O O O O O O O O O O O O O O
O O O O O O O O O O O O O O O O O O O O O O O O O O O O O O O O O O O O O O O O
O O O O O O O O O O O O O O O O O O O O O O O O O O O O O O O O O O O O O O O O
O O O O O O O O O O O O O O O O O O O O O O O O O O O O O O O O O O O O O O O O 
