data/musics/bgmusic.ogg
36 50
WWWEWWWWWWWOOOWWWWWWWWWWWWWOOOOOOOOO
WXXHXXXXXXWOOOWXXXXXXXXXXXWOOOOOOOOO
WXXXXXXXXXWOOOWXXXXXXXXXXXWOOOOOOOOO
WXXXXXXXXXWWWWWXXXXXXXXXXXWOOOOOOOOO
WXXXXSXXXXXXXXXXXXXXXXXXXXWOOOOOOOOO
WXXXXXXXXXXXXXXXXXXXXXXXXXWOOOOOOOOO
WXXXXXXXXXWWWWWXXXXXXXXXXXWOOOOOOOOO
WXXXXXXXXXWOOOWXXXXXXXXXXXWOOOOOOOOO
WWWWWWWWWWWOOOWXXXXXXXXXXXWOOOOOOOOO
OOOOOOOOOOOOOOWMXMXBXBXMXMWOOOOOOOOO
OOOOOOOOOOOOOOWXXXXXXXXXXXWOOOOOOOOO
OOOOOOOOOOOOOOWXXXXXXXXXXXWOOOOOOOOO
OOOOOOOOOOOOOOWXXXXXSXXXXXWOOOOOOOOO
OOOOOOOOOOOOOOWXXXXXXXXXXXWOOOOOOOOO
OOOOOOOOOOOOOOWXXXXXXXXXXXWOOOOOOOOO
OOOOOOOOOOOOOOWXXRXXRXXRXXWOOOOOOOOO
OOOOOOOOOOOOOOWXXXXXXXXXXXWOOOOOOOOO
OOOOOOOOOOOOOOWWWWWXXWWWWWWOOOOOOOOO
OOOOOOOOOOOOOOOOOOWXXWOOOOOOOOOOOOOO
OOOOOOOOOOOOOOOOOOWXXWOOOOOOOOOOOOOO
OOOOOOOOOOOOOOOOOOWXXWOOOOOOOOOOOOOO
OOOOOOOOOOOOOOOOOOWXXWOOOOOOOOOOOOOO
OOOOOOOOOOOOOOOWWWWXXWWWWOOOOOOOOOOO
OOOOOOOOOOOOOOOWXXXXXXXXWOOOOOOOOOOO
OOOOOOOOOOOWWWWWXXXXXXXXWWWWWOOOOOOO
OOOOOOWWWWWWXXXXXXXXXXXXXXXXWWWWWWOO
OOOOOOWRXXXMXXXXXXXXXXXXXXXXMXXXRWOO
OOOOOOWXXXMXXXXXXXXXXXXXXXXXXMXXXWOO
OOOOOOWLXBXXXXXXXXXSXXXXXXXXXXBXNWOO
OOOOOOWXXXMXXXXXXXXXXXXXXXXXXMXXXWOO
OOOOOOWRXXXMXXXXXXXXXXXXXXXXMXXXRWOO
OOOOOOWWWWWWXXXXXXXXXXXXXXXXWWWWWWOO
OOOOOOOOOOOWWWWWXXXXXXXXWWWWWOOOOOOO
OOOOOOOOOOOOOOOWXXXXXXXXWOOOOOOOOOOO
OOOOOOOOOOOOOOOWWWWXXWWWWOOOOOOOOOOO
OOOOOOOOOOOOOOOOOOWXXWOOOOOOOOOOOOOO
OOOOOOOOOOOOOOOOOOWXXWOOOOOOOOOOOOOO
WWWWWWWWWWOOOOOOOOWXXWOOOOOOOOOOOOOO
WXXXXXXXXWOOOOOOOOWXXWOOOOOOOOOOOOOO
WXXNLXXXXWOOOOOOOWWXXWOOOOOOOOOOOOOO
WXXXXXXXXWWWWWWWWWXXXWOOOOOOOOOOOOOO
WXXXXXXXXXXXXXXXXXXXXWOOOOOOOOOOOOOO
WXXDDXXXXXXXXXXXXXXXWWOOOOOOOOOOOOOO
WXXXXXXXXWWWWWWWWWWWWOOOOOOOOOOOOOOO
WXXXXXXXXWOOOOOOOOOOOOOOOOOOOOOOOOOO
WXXXXXXXXWOOOOOOOOOOOOOOOOOOOOOOOOOO
WWWWWWWWWWOOOOOOOOOOOOOOOOOOOOOOOOOO
OOOOOOOOOOOOOOOOOOOOOOOOOOOOOOOOOOOO
OOOOOOOOOOOOOOOOOOOOOOOOOOOOOOOOOOOO
OOOOOOOOOOOOOOOOOOOOOOOOOOOOOOOOOOOO
