musics/Arabesque.ogg
64 64
                           ###E###                              
                          ##..@..##                             
                         ##.......##                            
                        ##..........#                           
                        #...#...#...#                           
      #######          ##...#...#...##         #######          
     ##.....##         #....#...#....#        ##.....##         
     #..R....##        #.............#       ##....R..#         
     #........#        ##..#.....#...#       #........#         
    ##........##        #...#####...##      ##........##        
    #..........#        ##.........##       #..........#        
    #.R..M.M...##        ##.......##       ##...M.M..R.#        
    #...........#         #.S..S..#        #...........#        
    #..M..M..M..#         #.......#        #..M..M..M..#        
    #...........#    ######.......#####    #...........#        
    ##..........# ####................#### #..........##        
     #R.......B.###......................###.B........#         
     ##......B................................B.....R##         
      ##....B..................................B....##          
       ######..................................######           
            #..................................#                
           ##..................................##               
           #....................................#               
           #....................................#               
           #...........M......L....M............#               
           #....................................#               
          ##....................................##              
          #..............N.......N...............#              
          #...........................M..........#              
          #.........M............................#              
          #................B....B................#              
          #......................................#              
          #............L...........L.............#              
          #..................DD..................#              
          #.......................U..............#              
          #.................B..B.................#              
          #......................................#              
          #......................................#              
          ##.....................................#              
           #..........M............M............##              
           #.................L..................#               
           #....................................#               
           ##..................................##               
            #..................................#                
        #####..................................#####            
     ####..........................................####         
    ##.......B................................B.......##        
   ##.........B..............................B.........##       
   #...........B.#####RMMBMMMRRMMBMMMR#####.B...........#       
   #.............#   ##################   #.............#       
   #.............#                        #.............#       
  ##.............#                        #.......M.....##      
  #......M.......#                        #....M...M.....#      
  #.....M...M....#                        #.....M...M....#      
  #....M...M.....#                        #......M...M...#      
  #...M...M......#                        #.......M......#      
  ##.....M.......#                        #.............##      
   #............##                        ##............#       
   #............#                          #............#       
   ##..........##                          ##..........##       
    ####....####                            ####....####        
       ######                                  ######           
                                                                
                                                                
