data/musics/bgmusic.ogg
20 20
WWEWWWWWWWWWWWWWWWWW
WXHXXXXXXXXXXXXXXXXW
WXXXXXXXXXXXXXXXXXXW
WXXXXXXXXXXXXXXXXXXW
WXXXXXXXXXXXXXXXXXXW
WXXXXXXXXXXXXXXXXXXW
WXXXXXXXXXXXXXXXXXXW
WXXXXXXXXXXXXXXXXXXW
WXXXXXXXMMMXXXXXXXXW
WXXXXXXXXXXXXXXXXXXW
WXXXXXXXXXXXXXXXXXXW
WXXXXXXXXXXXXXXXXXXW
WXXXXXXXXXXXXXXXXXXW
WXXXXXXXXXXXXXXXXXXW
WXXXXXXXDDXXXXXXXXXW
WXXXXXXXXXXXXXXXXXXW
WXXXXXXXXXXXXXXXXXXW
WXXXXXXXXXXXXXXXXXXW
WXXXXXXXXXXXXXXXXXXW
WWWWWWWWWWWWWWWWWWWW
