data/musics/bgmusic.ogg
15 34
OOWWWWWWWWWEWOO
OOWXXXXXXXXHWOO
OOWXXXXKXXXXWOO
OOWXXXXXXXXXWOO
OOWXXXDDXXXXWOO
OOWXXXXXXXXXWOO
OOWXXXXXXXXXWOO
OOWXXXXXXXXXWOO
OOWXXXWWWWWWWOO
OOWXXXWOOOOOOOO
OOWXXXWOOOOOOOO
OOWXXXWWWWWWWOO
OOWXXXXXXXXNWOO
OOWXXXXXXXMXWOO
OOWXXXXXXXMXWOO
OOWXXXXXXXMXWOO
OOWXXXXXXXXXWOO
OOWXXXXXXXXXWOO
OOWXXXXXXXXXWOO
OOWWWWWWWXXXWOO
OOOOOOOOWXXXWOO
OOOOOOOOWXXXWOO
OOWWWWWWWXXXWOO
OOWXXXXXXXXXWOO
OOWXXLXXXXXXWOO
OOWXXMXXXXXXWOO
OOWXXMXXXXXXWOO
OOWXXMXXXXXXWOO
OOWXXXXXXXXXWOO
OOWXXXXXXXXXWOO
OOWXXXXDDXXXWOO
OOWXLXXXXXXXWOO
OOWXXXXXXXXXWOO
OOWWWWWWWWWWWOO
